পরিস্ফুটন	পরিস্ফুট
খেলেনি	খেল
শীতলা	শীত
পরাধীনতার	পরাধীন
মার্তা	মার্তা
মঙ্গোলিয়ার	মঙ্গোলিয়া
হলাম	হল
মারিয়া	মারিয়া
মিডিয়াম	মিডিয়াম
থামার	থাম
পঞ্চকোট	পঞ্চকোট
কৌশলও	কৌশল
চিরস্থায়ী	স্থায়ী
সঞ্জয়কে	সঞ্জয়
পিটের	পিট
খাবারও	খাবার
তলপেট	পেট
ব্রেন্ট	ব্রেন্ট
তীর্থস্থান	তীর্থস্থান
মৃৎশিল্প	মৃৎশিল্প
কার্যকাল	কার্যকাল
বিচারপ্রার্থী	বিচার
অলিম্পিয়াডের	অলিম্পিয়াড
বার্বার	বার্বার
সপরিবারে	পরিবার
করানো	করান
কানাডিয়ান	কানাডিয়ান
পাঠের	পাঠ
বার্তাটির	বার্তা
প্যাকের	প্যাক
বামদের	বাম
ভদ্রতা	ভদ্র
টেকনোলজি	টেকনোলজি
বেচারার	বেচারা
ম্যাজিস্ট্রেট	ম্যাজিস্ট্রেট
রেখেছ	রেখ
স্ক্রীনশট	স্ক্রীনশট
দার্জিলিং	দার্জিলিং
স্প্রিংকলার	স্প্রিংকলা
নাটোর	নাটোর
বরফি	বরফ
ওয়াইল্ড	ওয়াইল্ড
মঞ্জিল	মঞ্জিল
ঈর্ষা	ঈর্ষা
থমসন	থমসন
ক্যাশের	ক্যাশ
ডুবে	ডুব
নিই	নিই
বদ্ধ	বদ্ধ
পাউন্ডের	পাউন্ড
ল্যাডার	ল্যাডার
বিন্যাসযোগ্য	বিন্যাস
রুজু	রুজু
ওটস	ওটস
মিলিয়ন	মিলিয়ন
স্বাস্থ্যসম্মত	স্বাস্থ্য
মন্ত্রণা	মন্ত্র
বাছতে	বাছ
খেলাটাকে	খেলা
ব্রাভোর	ব্রাভো
নিত্যপণ্যের	নিত্যপণ্য
বোঝা	বোঝা
কিসমিস	কিসমিস
দীননাথ	দীন
উৎসর্গকৃত	উৎসর্গ
পতাকাবাহী	পতাকা
সিনিয়রের	সিনিয়র
লাইনও	লাইন
রিডারের	রিডার
লেবাননের	লেবানন
টেলিনর	টেলিনর
রঙ্গমঞ্চ	মঞ্চ
স্লুইসগেট	স্লুইসগেট
পাওনি	পাও
যাব	যাব
বিক্ষিপ্ত	বিক্ষিপ্ত
থালায়	থালা
পরিবাহীর	পরিবাহী
ওঠেন	ওঠ
নিরাপত্তাবিষয়ক	নিরাপত্তা
ছিটমহল	ছিটমহল
বাসায়	বাসায
জুনের	জুন
গদ্যে	গদ্য
ধোঁকা	ধোঁকা
দোকানিদের	দোকান
টুকরার	টুকরা
খ্রীষ্টানরা	খ্রীষ্টান
নাইজেরিয়াকে	নাইজেরিয়া
অমিতের	অমিত
বাগাতিপাড়া	বাগাতিপাড়া
টেবিলের	টেবিল
পদ্মিনী	পদ্ম
পাঠাইনি	পাঠাই
কাউন্সিলম্যান	কাউন্সিল
সামোয়া	সামোয়া
শক্তিগুলোর	শক্তি
সাতক্ষীরার	সাতক্ষীরা
কিছুদিনের	কিছুদিন
আরমাগিদোনের	আরমাগিদোন
ব্রঙ্কসে	ব্রঙ্কস
হরফ	হরফ
ফ্রেইট	ফ্রেইট
ধারণাটির	ধারণা
আলোর	আলো
চারটা	চার
সাইফুর	সাইফুর
শেলডন	শেলডন
ইভো	ইভো
মৈত্রীর	মৈত্রী
রাজ্যাভিষেক	রাজ্য
মাহিন্দা	মাহিন্দা
দিয়েছো	দিয়
স্টপেজে	স্টপেজ
চাকুরির	চাকুরি
প্রসূতির	প্রসূতি
নজিবুল	নজিবুল
রোমানা	রোমানা
মেম্বারদের	মেম্বার
আধান	আধান
আমীরুল	আমীরুল
আগমণ	আগমণ
বেরোবে	বের
নিউজকে	নিউজ
সংক্রমন	সংক্রমন
সাম্প্রতিকতম	সাম্প্রতি
মিনিস্টিরিয়াল	মিনিস্টিরিয়াল
বেন্ট	বেন্ট
উসুল	উসুল
নৈরাজ্য	রাজ্য
আইনিভাবে	আইন
ডারবানের	ডারবান
ধুলো	ধুল
ফাঁসে	ফাঁস
ইয়েটস	ইয়েট
কোপ	কোপ
ঘুরেছি	ঘুর
আলোই	আলো
এন্ডগেম	এন্ডগেম
ঘটনাগুলোর	ঘটনা
সাতকানিয়ার	সাত
টারবচার্জার	চার্জার
মতভেদের	মতভেদ
মূসকের	মূসক
মেহেরবান	মেহেরবান
পুনঃপ্রতিষ্ঠা	প্রতিষ্ঠা
জনপ্রতিনিধিসহ	জনপ্রতিনিধি
নিখোঁজের	নিখোঁজ
তহবিল	বিল
টনের	টন
তাম্র	তাম্র
মহাগর	মহাগর
ত্বরণে	ত্বরণ
খননকারী	খনন
অপ্রাপ্তবয়স্কদের	প্রাপ্ত
মেট্রোতে	মেট্রো
টেম্পোর	টেম্পো
ধারাবাহিকের	ধারাবাহিক
রামায়ণ	রামায়ণ
ফলশ্রুতি	ফল
ব্দে	ব্দে
অন্দরমহল	অন্দর
হেনস্তা	হেনস্তা
স্বত্ত্বেও	স্বত্ত্বে
সময়টাই	সময়
শিক্ষাদানের	শিক্ষাদান
সেগুন	সেগুন
জুরিবোর্ডের	জুরিবোর্ডের
সমভূমি	ভূমি
হোমের	হোম
বলেছে	বল
প্রশ্নেও	প্রশ্ন
শান্তিময়	শান্তি
স্টুয়ার্ট	স্টুয়ার্ট
জানতামই	জানতাম
গ্রামেও	গ্রাম
কনিষ্ঠা	কনিষ্ঠ
নায়িকারা	নায়িকা
আর্কিটেকচারাল	আর্কিটেকচারাল
বিবেচনাধীন	বিবেচনাধীন
ঘোর	ঘোর
ভাইদেরকে	ভাই
মঠের	মঠ
আফ্রিকাকে	আফ্রিকা
ইতিহাসটি	ইতিহাস
স্থাপনাকে	স্থাপন
বর্ষীয়ান	বর্ষ
কোকোর	কোক
তেজস্ক্রিয়তা	তেজস্ক্রিয়
প্রদর্শনীচলবে	প্রদর্শন
ডগলাস	ডগলাস
দৌলতপুরে	দৌলতপুর
মুমিনগণকে	মুমিন
নিকোলস	নিকোলস
তৎসত্ত্বেও	তৎসত্ত্ব
মেরুদন্ডী	মেরুদন্ড
হুয়ান	হুয়ান
ইউনিয়নসহ	ইউনিয়ন
বিএসটিআই	বিএসটিআই
অধ্যায়ের	অধ্যায়
খুলবে	খুলব
পরিসংখ্যানও	পরিসংখ্যা
উহা	উহা
শ্রেণীতে	শ্রেণী
তামান্না	তামান্না
দৈত্যের	দৈত্য
রোয়াংছড়ি	রোয়াংছড়ি
যখনই	যখনই
খেলিনি	খেলি
শুঁটকি	শুঁটকি
কাব্যগ্রন্থ	কাব্য
পাকিস্তানই	পাকিস্তান
তিনবারের	তিন
নিরাপত্তাকে	নিরাপত্তা
ঘটিয়ে	ঘট
পূর্বপুরুষরা	পুরুষ
রাখলেই	রাখ
কন্ট্রোলারের	কন্ট্রোলার
হবেন	হব
ইথানল	ইথানল
অধ্যক্ষকে	অধ্যক্ষ
বিপজ্জনকভাবে	বিপজ্জনক
এলিভেটেড	এলিভেটেড
হ্রাসে	হ্রাস
মিয়ানওয়ালী	মিয়া
ঘটনাটির	ঘটনা
কুতুবপুর	কুতুবপুর
দানে	দান
সরলীকরণ	সরলীকরণ
বইছে	বই
মোহনায়	মোহনা
চরাঞ্চলের	চরাঞ্চল
জুম্ম	জুম্ম
এলগার	এলগা
থাকাবস্থায়	থাকা
মুন্নার	মুন্না
পিছনের	পিছন
বিশেষজ্ঞের	বিশেষজ্ঞ
তামাদি	তামা
নিরাপত্তাসহ	নিরাপত্তা
অবমুক্ত	অবমুক্ত
তারাদের	তারা
নাহিয়ান	নাহিয়ান
গোল্ড	গোল্ড
উপহার	উপহার
মাতাল	মাতাল
কবিতাগুলোর	কবিতা
সালাতের	সালাত
যেকটি	যেকটি
ত্রিবার্ষিক	বার্ষিক
নানু	না
প্রতিনিয়ত	প্রতিনিয়ত
আলোচনাও	আলোচনা
পাতলা	পাতলা
কৌতুহল	কৌতুহল
শুল্কাধীন	শুল্ক
বাহা	বাহা
হাজারো	হাজার
মোল্যা	মোল্যা
ইলা	ইলা
খেলতেন	খেল
মহানবি	মহানবি
সিনেটে	সিনেট
গতকালের	গত
গ্রামেগঞ্জে	গ্রাম
জ্ঞানী	জ্ঞান
ইন্ডিয়ার	ইন্ডিয়া
রাসায়নিকের	রাসায়নিক
কেরালায়	কেরালায়
স্ট্র্যাটেজিক	স্ট্র্যাটেজি
প্রতিবাদও	প্রতিবাদ
বাটনের	বাটন
স্যাররা	স্যার
ক্রাফট	ক্রাফট
রোজিনা	রোজিনা
চট্টগ্রামসহ	চট্টগ্রাম
ইউআইইউ	ইউআইইউ
লোকজ	লোকজ
পুর্বের	পুর্ব
দিয়ার	দিয়া
বার্তা	বার্তা
ব্যয়ের	ব্যয়
খামারবাড়ি	খামার
ফোঁটা	ফোঁটা
তৃক	তৃক
ডালি	ডালি
লাইটে	লাইট
জেএমবির	জেএমবি
কর্মকাণ্ড	কর্ম
নির্ধারন	নির্ধারন
কামনায়	কামনা
অগ্নিশিখা	অগ্নিশিখা
ফ্রান্সিসকোতে	ফ্রান্সিসকো
যন্ত্রগুলো	যন্ত্র
বিশুদ্ধরুপে	বিশুদ্ধরুপ
এশা	এশা
অস্ত্রধারীরা	অস্ত্রধারী
ইমরুলের	ইমরুল
আবাসভূমি	আবাস
বর্তমান	বর্তমান
অফিসেই	অফিস
শ্রফ	শ্রফ
এক্সবক্স	এক্সবক্স
ঈপ্সিত	ঈপ্সিত
এভিনিউ	এভিনিউ
কলম্বিয়ার	কলম্
শৈশবে	শৈশব
নৈশভোজ	নৈশভোজ
দেবেন	দেব
ঘামায়	ঘাম
ধাতুবিদ্যা	ধাতুবিদ্যা
মজিবুল	মজিবুল
বিজ্ঞাপনে	বিজ্ঞাপন
দুঃস্বপ্নের	দুঃস্বপ্ন
আমীরে	আমীর
রসায়নে	রসায়ন
ছিন্ন	ছিন্ন
পর্যায়বৃত্ত	পর্যায়
হ্যামস্টার	হ্যামস্টার
ঘটনাবহুল	ঘটনা
অশ্বিনের	অশ্বিন
পূজামণ্ডপ	পূজামণ্ডপ
বাহিত	বাহিত
পাদদেশের	দেশ
আমারা	আমার
রিক্ত	রিক্ত
মুছাইয়া	মুছাইয়া
ফ্যানরা	ফ্যান
সুমি	সুমি
শৈশবকালে	শৈশব
বস্ত্র	বস্ত্র
থানে	থান
কাশী	কাশী
বিয়ার	বিয়া
সেল্টিকের	সেল্টিক
নুরী	নুর
জেরুসালেম	জেরুসালেম
গুপ্তা	গুপ্ত
ভাবলাম	ভাব
বাইশে	বাইশ
এরপর	এরপর
দক্ষতাঃ	দক্ষতা
লাগিয়েছিল	লাগিয়ে
জেফ্রি	জেফ্রি
এডিটরস	এডিটর
নাগরিকসহ	নাগরিক
কামরুন	কামরুন
দিনগুলিতে	দিন
বসলেন	বসল
বিজোড়	বিজোড়
সুখময়	সুখ
ভবনকে	ভবন
পরিচালকরা	পরিচালক
মুক্তবুদ্ধির	মুক্তবুদ্ধি
করিয়েছে	করিয়ে
তুমিতো	তুমি
উইকেটটা	উইকেট
পাতাটি	পাতা
তাইনা	তাই
প্রীতির	প্রীতি
দুজন	জন
পঙ্গুত্ব	পঙ্গু
পুরস্কারটির	পুরস্কার
কংগ্রেসও	কংগ্রেস
উন্নয়ন	উন্নয়ন
তাঁতের	তাঁত
আলাপচারিতার	আলাপ
কল্কি	কল্কি
কলম্বিয়ান	কলম্বিয়ান
কোমা	কোমা
মাইক্রোবাস	মাইক্রোবাস
যেটুকু	যেটুকু
চিবুকের	চিবুক
প্রথমতঃ	প্রথম
হারব	হার
মোস্তাকিম	মোস্তাকিম
পয়েন্টের	পয়েন্ট
ম্যাকআর্থার	ম্যাকআর্থার
মিশরীয়	মিশর
রেণী	রেণী
যাত্রী	যাত্রী
চালকের	চালক
একজনের	এক
ভোটাভুটি	ভোটাভুটি
বলবে	বল
নাকের	নাক
সাতার	সাতার
সরে	সর
প্রতিমন্ত্রীর	প্রতিমন্ত্রী
সন্দ্বীপে	সন্দ্বীপ
ড্রাইভটি	ড্রাইভ
রোমানি	রোমান
ব্রিটিশরা	ব্রিটিশ
জোগায়	জোগায়
পার্টি	পার্টি
চলেন	চল
সুরভি	সুরভি
জানাযা	জানাযা
দেখবে	দেখ
সঙ্গীতায়োজন	সঙ্গীত
বাঙ্গালি	বাঙ্গালি
স্বরাজ	স্বরাজ
মাইগ্রেনের	মাইগ্রেন
রিলিফের	রিলিফ
ডেভেলপার	ডেভেলপার
টেররিজম	টেররিজম
সুস্থিত	সুস্থিত
আশঙ্কাকে	আশঙ্কা
ইনজেকশনের	ইনজেকশন
বেস্টসেলার	বেস্ট
পাঁচটি	পাঁচ
ডিলানের	ডিলান
দিয়েও	দিয়ে
কোমি	কোমি
আদমদীঘি	আদমদীঘি
আটচালা	আটচালা
নিক্ষেপণ	নিক্ষেপ
চিনা	চিন
রোগটি	রোগ
লোহা	লোহা
রোলস	রোলস
যাধি	যাধি
দুর্ভাগ্যবশত	দুর্ভাগ্য
আগামীতেও	আগামী
স্বর্ণের	স্বর্ণ
স্মারকগ্রন্থ	স্মারক
মামুনুর	মামুনুর
এসএস	এসএস
বইটা	বই
করিনা	করি
বাবিলনের	বাবিলন
ভোক্তারা	ভোক্তা
মোয়াজ্জেমের	মোয়াজ্জেম
যাত্রাকে	যাত্রা
কাপ্তাইয়ে	কাপ্তাই
ঝলক	ঝলক
সবকিছুতেই	সবকিছু
রক্ষার্থে	রক্ষা
ট্যাবলেটের	ট্যাবলেট
পুঞ	পুঞ
রিকু	রিকু
পাঠালেন	পাঠাল
এসএইচএ	এসএইচএ
শোষন	শোষন
প্রেসিডেন্সি	প্রেসিডেন্সি
নিজেরাই	নিজ
নয়াদিল্লিতে	নয়াদিল্লি
বাজারের	বাজার
লন্ডনের	লন্ডন
দালানটি	দালান
ক্রিস্তিয়ানো	ক্রিস্তিয়ানো
স্তম্ভ	স্তম্ভ
উপাদানগুলি	উপাদান
মাহজাবিন	মাহজাবিন
পরিবারবর্গের	পরিবার
পরোক্ষে	পরোক্ষ
রসূলও	রসূল
হাঁস	হাঁস
ডালিম	ডালিম
হয়েছিল	হয়
কামরার	কামরা
উৎপত্তির	উৎপত্তি
তফসিলি	তফসিল
অঞ্চলটিতে	অঞ্চল
সংস্করণের	সংস্করণ
বন্ধুসহ	বন্ধু
টর্নেডোর	টর্নেডো
চেহারাকে	চেহারা
ফেরাউন	ফেরাউন
গ্রেটা	গ্রেটা
বাজেভাবে	বাজে
রেডঃ	রেড
ঢালে	ঢাল
মিজানুল	মিজানুল
অভিমান	মান
নীতিমালাটি	নীতি
ঢালাও	ঢাল
বইগুলি	বই
সারথি	সারথি
মনোযোগকে	মনোযোগকে
চেকপোস্টে	পোস্ট
লোকি	লোক
চরিত্রটিতে	চরিত্র
ডাহা	ডাহা
গাইতাম	গাইতাম
হোসেনি	হোসেনি
ইঙ্গিতই	ইঙ্গিত
ফ্রিস্টাইলে	ফ্রিস্টাইল
খুলেছি	খুল
তাইওয়ানের	তাইওয়ান
ভোগদখল	ভোগদখল
সোমপুর	সোমপুর
নেতাকর্মীরা	নেতা
গম্বুজের	গম্বুজ
তারিখেই	তারিখ
শৈশবেই	শৈশব
নিয়মে	নিয়ম
ব্যাংককের	ব্যাংকক
কনসার্টের	কনসার্ট
ফিরমিনো	ফিরমিনো
স্বভাবগত	স্বভাব
স্টার্চ	স্টার্চ
বাস্তবিকপক্ষে	বাস্তব
সমালোচকরা	সমালোচক
ক্যানভাসের	ক্যানভাস
দোকানগুলোয়	দোকান
যালেমদের	যালেম
ঝোঁকে	ঝোঁক
বৃদ্ধিরত	বৃদ্ধি
স্কেলে	স্কেল
অংশীদারি	অংশীদার
পৌরুষ	পৌরুষ
থামতেই	থাম
নিউরাল	নিউরাল
দনিয়া	দনিয়া
ফোর্সে	ফোর্স
আকাঙ্ক্ষী	আকাঙ্ক্ষ
বাজেটে	বাজেট
কাঁদছেন	কাঁদছ
রূপান্তরের	রূপান্তর
নাখোশ	খোশ
মাখা	মাখা
মাত্রাটা	মাত্রা
প্রভাবান্বিত	প্রভাব
পৃথিবীটাকে	পৃথিবী
ফাস্টফুডের	ফাস্টফুড
দেখবো	দেখ
কনট্যুর	কনট্যুর
রাস্তাঘাটে	রাস্তা
মরিচের	মরিচ
ফাঁদে	ফাঁদ
ইটিভি	ইটিভি
ভালোয়	ভালো
পদ্মায়	পদ্মা
চলচিত্র	চিত্র
উইলিয়ম	উইলিয়ম
ম্যাক্সওয়েলের	ম্যাক্সওয়েল
আইসিবির	আইসিবি
হজম	হজম
তোড়জোড়	জোড়
বিতাড়িত	বিতাড়িত
জানায়	জান
নবনির্বাচিত	নির্বাচিত
উপসর্গগুলি	উপসর্গ
মিউচুয়াল	মিউচুয়াল
পোশাকি	পোশাক
অফিসগুলো	অফিসগুলো
নজিরবিহীন	নজিরবিহীন
সফটওয়ার	সফটওয়ার
কতটি	কত
আশ্রয়	আশ্রয়
উপনিষদে	উপনিষদ
শিল্পপতিদের	শিল্প
পরামর্শদাতাদের	পরামর্শদাতা
বসতঘর	বসত
অ্যান্টিগা	অ্যান্টিগা
অনুপ্রেরণামূলক	প্রেরণা
রেস্তোঁরা	রেস্তোঁরা
বাড়ানোর	বাড়ানো
খেলা	খেলা
তিউনিশীয়	তিউনিশীয়
হাছন	হাছন
ডালাস	ডালাস
সমুহ	সমুহ
বলিয়া	বল
তৃতীয়জন	তৃতীয়
পিএসআই	পিএসআই
যাদা	যাদা
বুনতে	বুনত
গ্লোবের	গ্লোব
কাবাবের	কাবাব
লরেল	লরেল
মুছিয়া	মুছ
পরিবেশনার	পরিবেশনা
ভন্ড	ভন্ড
প্রকাশনা	প্রকাশ
অভিযাত্রীদের	যাত্রী
একাকিত্বের	একাকিত্ব
উপায়ই	উপায়
সন্ধ্যাটা	সন্ধ্যা
মহল্লায়	মহল্লা
ফাগুন	ফাগুন
নরকে	নরক
সাক্ষাতে	সাক্ষাত
লোগোটি	লোগো
ক্যামেরায়	ক্যামেরা
সভাতেই	সভা
দেশসেরা	সেরা
রতিপালক	রতিপালক
লীগে	লীগ
ওভারের	ওভার
গোমরাহ	গোমরাহ
লোডার	লোড
শয়তানের	শয়তান
নদীপথে	নদী
বহুতল	বহুতল
বিডিনিউজ	বিডিনিউজ
হাইড্রো	হাইড্রো
হুলিয়ান	হুলিয়ান
থ্যাংক	থ্যাংক
উপগ্রহের	গ্রহ
বিশ্বজয়ের	বিশ্বজয়
মালির	মালি
এন্টিক	এন্টিক
অরূপ	অরূপ
বিশ্বকোষ	বিশ্বকোষ
সামিল	সামিল
খাদ্যসংকট	খাদ্য
জাটকা	জাটকা
ডাইমেনশন	ডাইমেনশন
অর্ডিনেটর	অর্ডিনেট
সুহানা	সুহানা
কেমিক্যালের	কেমিক্যাল
অস্ট্রিয়ার	অস্ট্রিয়া
ম্যাপের	ম্যাপ
আতাউস	আতাউস
মোটরস	মোটর
কামারুজ্জামানের	কামারুজ্জামান
চিবোতে	চিবো
কাঁটাতার	কাঁটা
বিভব	বিভব
ক্লিওপেট্রা	ক্লিওপেট্রা
ওয়াইফাই	ওয়াইফাই
মিলির	মিলি
মঈনুল	মঈনুল
প্রিয়তি	প্রিয়তি
বোলাররূপে	বোলার
সিরিজও	সিরিজ
অকর্মা	কর্ম
হ্যাডলি	হ্যাডলি
নিরঙ্কুশ	নিরঙ্কুশ
পেশী	পেশী
ডেসটিনি	ডেসটিনি
এলডিসির	এলডিসি
তানজির	তানজির
মইনুল	মইনুল
কেম্যান	ম্যান
ফলপ্রসূ	ফলপ্রসূ
রাখতাম	রাখতাম
ললিতা	ললিতা
আচরনের	আচরন
এমপিরা	এমপি
সিলিন্ডারের	সিলিন্ডার
আগমনে	আগমন
বিশ্ববিদ্যালয়েও	বিশ্ববিদ্যালয়
সাইটগুলোর	সাইট
এনআরবি	এনআরবি
চাইতেও	চাইতে
জলস্তর	জল
শোআইব	শোআইব
মরগান	মরগান
বিটের	বিট
সালাউদ্দিনকে	সালাউদ্দিন
এলজিইডির	এলজিইডি
প্রবৃত্তি	প্রবৃত্তি
আত্মসাতের	আত্মসাত
বিবর্ণতা	বিবর্ণ
কার্বোহাইড্রেট	কার্বোহাইড্রেট
থেকে	থেকে
ভরাটের	ভরাট
গর্ভাবস্থায়	গর্ভাবস্থা
পোল্ট্রি	পোল্ট্রি
মাফ	মাফ
প্রিমিয়াম	প্রিমিয়াম
বায়ুশূন্য	বায়ু
স্পোর	স্পোর
গ্যাসীয়	গ্যাস
জিনিসকে	জিনিস
অবমাননা	অবমাননা
ভুট্টা	ভুট্টা
ফায়ারে	ফায়ার
গেমটি	গেম
বোদা	বোদা
সৌন্দর্যবর্ধনের	সৌন্দর্য
আরিফুলকে	আরিফুল
হুবার্ট	হুবার্ট
কম্পাঙ্ক	কম্পাঙ্ক
অবস্থাও	অবস্থা
কলকাতায়	কলকাতা
যদাতা	যদাতা
মানেকা	মানেকা
লোকরা	লোক
স্ক্রাব	স্ক্রাব
এইচটিটিপি	এইচটিটিপি
গ্রন্থিত	গ্রন্থ
হাটার	হাটা
আপ্যায়ন	আপ্যায়ন
পেকে	পেকে
তোলা	তোল
কাজগুলো	কাজ
কয়েদিরা	কয়েদি
বৈকল্পিক	বৈকল্প
লকেট	লকেট
গুণগুলোর	গুণ
পূর	পূর
লারা	লারা
পাতিলের	পাতিল
ডেইজি	ডেইজি
এক্ষেত্রে	ক্ষেত্র
হাতিয়ার	হাতিয়ার
আশ্বাসে	আশ্বাস
দস্তাবেজের	দস্তাবেজ
অ্যাকসেস	অ্যাকসেস
ওয়েভ	ওয়েভ
প্রোডাকটিভিটি	প্রোডাকটিভ
আসল	আসল
করতঃ	কর
কারাবাস	কারাবাস
তাপীয়	তাপ
পিতাঃ	পিতা
দুর্বলতার	দুর্বল
রাজ্যসমূহ	রাজ্য
খাওয়াতে	খাওয়া
মোল্লাকে	মোল্লা
অঞ্চলগুলোতে	অঞ্চল
পাঠানোর	পাঠা
রঞ্জন	রঞ্জ
প্রাণিকুল	প্রাণি
বড়বাজার	বাজার
জার্মানি	জার্মান
সন্মান	সন্মান
প্রোফাইলে	প্রোফাইল
কেনেন	কেনে
টকটকে	টকটকে
আজান	আজান
কার্যনির্বাহক	কার্য
ডিওএইচএস	ডিওএইচএস
গণমিছিল	মিছিল
সৈকতে	সৈকত
হাড়	হাড়
সলাজ	সলাজ
রাজা	রাজ
জাহাজগুলোকে	জাহাজ
বাবুলকে	বাবুল
কণ্ঠস্বরকে	কণ্ঠ
মৃত্যুঝুঁকি	মৃত্যু
ইসরাঈলের	ইসরাঈল
বেষ্টন	বেষ্টন
রাবারের	রাবার
উপলব্ধ	লব্ধ
লুব্রিকেটিং	লুব্রিকেটিং
সিদ্ধান্তগুলো	সিদ্ধান্ত
রেল	রেল
ঐশ্বর্য	ঐশ্বর্য
ডাইভারসিটি	ডাইভারসিটি
পূজারী	পূজা
কলামটি	কলাম
পোর্টস	পোর্টস
শুভাকাঙ্ক্ষীরা	শুভাকাঙ্ক্ষী
পুরস্কারের	পুরস্কার
কনুই	কনুই
চার্ট	চার্ট
অনুপ্রবেশকারীদের	প্রবেশ
অংকন	অংক
দরজা	দর
ট্রয়ের	ট্রয়
গুণতে	গুণ
উপরিতলে	উপরিতল
স্থলাভিষিক্ত	স্থলাভিষিক্ত
সত্যের	সত্য
সার্ভিসকে	সার্ভিস
তেজস্ক্রিয়তার	তেজস্ক্রিয়
গড়া	গড়া
ফেরেন	ফের
বিশ্ববিদ্যালয়গুলো	বিশ্ববিদ্যালয়
ঠায়	ঠায়
লোকটি	লোক
মৃত্যুদণ্ডের	মৃত্যুদণ্ড
মেরী	মেরী
ব্যাপারীর	ব্যাপারী
গলান	গলা
মাদবর	মাদবর
প্রয়োজনীয়তার	প্রয়োজনীয়তা
শিল্পীদের	শিল্পী
উপাদানগুলিকে	উপাদান
জর্দান	জর্দান
জয়পুরহাটের	জয়পুরহাট
গণনা	গণ
সমষ্টি	সমষ্টি
তাজউদ্দিন	তাজউদ্দিন
হলোঃ	হলো
পড়েছি	পড়
শশী	শশী
মিটবে	মিটবে
তাছাড়াও	ছাড়া
ফেরতের	ফেরত
চৌকস	চৌকস
ক্রিয়াকলাপের	ক্রিয়াকলাপ
বিল্ড	বিল্ড
মোটরগাড়ি	মোটর
নৈরাজ্যবাদী	নৈরাজ্য
অযোধ্যা	অযোধ্যা
তুষার	তুষার
মাংসপেশী	মাংস
অ্যাপলের	অ্যাপল
সাইটটিতে	সাইট
চেকপোস্ট	চেকপোস্ট
সাটা	সাটা
ওয়েইবো	ওয়েইবো
আমলাতান্ত্রিক	আমলা
উপাসকরা	উপ
রেখেছিলো	রেখ
জনতাকে	জনতা
সৌরশক্তি	সৌরশক্তি
যুক্তরাজ্যের	যুক্তরাজ্য
আরএকে	আরএ
দায়েরের	দায়ের
জলবিদ্যুৎ	জলবিদ্যুৎ
আমরাই	আমরা
আলিবাবার	আলিবাবা
মির্জা	মির্জা
উৎসুকভাবে	উৎসুক
রতিযোগিতা	যোগ
চেং	চেং
ব্যায়ামাগার	ব্যায়াম
কুলপতি	কুল
ঘনীভূত	ঘন
রূপচাঁদা	রূপচাঁদা
মতেই	মত
আশাপ্রদ	আশাপ্রদ
গহীন	গহ
নুরুন্নবী	নুরুন্নবী
জহিরের	জহির
প্লেয়ারে	প্লেয়ার
প্রতিবন্ধীদের	প্রতিবন্ধী
ভোলাকে	ভোলা
স্কাইড	স্কাইড
বিকেলটা	বিকেল
রাউন্ডারের	রাউন্ডার
শাকিলা	শাকিলা
বাংলাদেশেই	বাংলাদেশ
দ্বেষ	দ্বেষ
লুটপাট	লুট
গভর্নরদের	গভর্নর
পেন্সিল	পেন্সিল
লঘিষ্ঠ	লঘিষ্ঠ
ব্যাবসায়	ব্যাবসা
কমনওয়েলথের	কমনওয়েলথ
বলিনি	বলি
গাইত	গাইত
পরেন	পরে
বাসস্থান	স্থান
বাঁচেন	বাঁচ
কথাতে	কথা
শোনালেও	শোনাল
প্রেমিকদের	প্রেমিক
গাঢ়	গাঢ়
হাবিবুল	হাবিবুল
জ্বিন	জ্বিন
গয়না	গয়না
আবেদনকে	আবেদন
অনুমতিপত্র	অনুমতি
সিটি	সিটি
গতিকে	গতি
অ্যানিমেল	অ্যানিমেল
খাদ্যের	খাদ্য
ডেথলি	ডেথ
ফলাফলের	ফল
মারিয়ানো	মারিয়ানো
আফগানদের	আফগান
যেটা	যেটা
আকতারের	আকতার
সন্দীপন	সন্দীপন
সুবিধাই	সুবিধা
অ্যাক্সেস	অ্যাক্সেস
গ্রন্থকেন্দ্র	গ্রন্থ
দিয়েছিল	দিয়েছ
গোরস্থানে	স্থান
ফরিদপুরে	ফরিদপুর
ইয়ন	ইয়ন
যেমনটা	যেমন
বায়োগ্রাফি	বায়োগ্রাফ
মোখলেসুর	মোখলেসুর
লিখত	লিখ
কুয়েতের	কুয়েত
ঘুরানোর	ঘুরা
মসুল	মসুল
করতাম	কর
থিসারা	থিসারা
পরামর্শও	পরামর্শ
কালিজিরা	কালিজিরা
খেললেও	খেল
গোসলখানা	গোসল
কৃষকই	কৃষক
পর্যটনকে	পর্যটন
ক্যামব্রিজের	ক্যামব্রিজ
জাতীয়তাবাদীরা	জাতীয়
ছোটোবেলা	ছোট
গবেষণা	গবেষণা
তোহা	তোহা
অস্থায়ী	স্থায়ী
বক্ষ	বক্ষ
রচনাগুলো	রচনাগুলো
লাইলী	লাইলী
স্ন্যাপস	স্ন্যাপ
জেএফ	জেএফ
তাকা	তাকা
সিস্টার্স	সিস্টার্স
প্রজাপতি	প্রজাপতি
জেলের	জেলে
বলিয়ে	বলি
টেলিস্কোপের	টেলিস্কোপ
মোহ	মোহ
ইসরো	ইসরো
অলিভিয়ের	অলিভ
টকর	টকর
হেগ	হেগ
বামনা	বামন
হোপের	হোপ
গুজরাটের	গুজরাট
শরতের	শরত
অনাবাদি	অনাবাদি
রিপোর্টারের	রিপোর্টার
জ্যেষ্ঠতার	জ্যেষ্ঠ
টেবিল	টেবিল
বাড়ী	বাড়ী
আবুদাঊদ	আবুদাঊদ
বঙ্গোপসাগর	বঙ্গ
সুযোগ	সুযোগ
অনুষ্ঠানটিকে	অনুষ্ঠান
হাবীবের	হাবীব
যোগব্যায়াম	ব্যায়াম
তাফসীর	তাফসীর
বন্ধও	বন্ধ
অর্ধেকের	অর্ধেক
ইউপিএ	ইউপি
কল্য	কল্য
সুরটি	সুর
বাক্যগুলো	বাক্য
হাবের	হাব
থিয়েটারের	থিয়েটার
সেপ্টেম্বরের	সেপ্টেম্বর
ফিনদের	ফিন
সফরকালে	সফর
বাবাসহ	বাবা
অটোরিকশায়	রিকশা
শাওয়ার	শাওয়ার
ল্যান্ডলাইন	ল্যান্ডলাইন
যাকেই	যাকে
ট্যাক্সিচালক	ট্যাক্সি
ভূমন	ভূমন
নীলাচল	নীলাচল
নূরে	নূর
জাতি	জাত
আত্মাকে	আত্মা
ফাইন্যান্সের	ফাইন্যান্স
তরুণেরাই	তরুণ
সাতের	সাত
শিক্ষকেরাই	শিক্ষক
চারবার	চার
সল্ট	সল্ট
লাথি	লাথি
রোমান্টিকতা	রোমান্টিক
ফজলে	ফজল
দেশাই	দেশ
লিঙ্গানুপাত	লিঙ্গ
আমগাছে	আম
গাইডলাইন	গাইডলাইন
অক্সাইডের	অক্সাইড
গ্রিসকে	গ্রিস
ঘোষণাও	ঘোষণা
হোম	হোম
মহাব্যবস্থাপকের	ব্যবস্থা
কাপে	কাপ
চিকিত্সক	চিকিত্সক
পক্ষপাত	পক্ষ
ফোড়া	ফোড়া
প্রশিক্ষণে	প্রশিক্ষণ
ফোনসেট	ফোনসেট
বাসিন	বাসিন
ফিদা	ফিদা
শুরু	শুরু
এগারটি	এগার
বিজেএমসি	বিজেএমসি
সেলেনিয়াম	সেলেনিয়াম
স্পাইস	স্পাইস
সাইটগুলোতে	সাইট
ফুলদানিতে	ফুলদানি
মাহফুজুর	মাহফুজুর
কিয়োটো	কিয়োটো
রোডসহ	রোড
হিন্দুধর্মের	হিন্দুধর্ম
গুপ	গুপ
থিংস	থিংস
ব্যাবস্থাপনা	ব্যাবস্থা
ওয়াটসনের	ওয়াটসন
হালে	হাল
ধৈর্যধারণ	ধৈর্য
আর্মিতে	আর্মি
ওবামার	ওবামা
আনন্দমোহন	আনন্দ
স্পিকারের	স্পিকার
মরিচ	মরিচ
প্রচ্ছদে	প্রচ্ছদ
জিৎ	জিৎ
ভিতরেই	ভিতর
কার্বনেটেড	কার্বন
লাইসেন্সকৃত	লাইসেন্স
ভারবাহী	ভার
অনাকাঙ্খিত	কাঙ্খিত
কতগুলি	কত
আউল	আউল
সড়কই	সড়ক
বহুগুণে	বহুগুণ
কাউন্টেস	কাউন্ট
মাগুরার	মাগুরা
ড্রেস	ড্রেস
ব্লাডি	ব্লাড
ইভানোভিচ	ইভানোভিচ
গ্রিজমান	গ্রিজমান
শাখায়	শাখা
চেকিং	চেক
ভাববাণী	ভাব
একথাই	একথা
মুসল্লিদের	মুসল্লি
জিডিপির	জিডিপি
ব্যালকনিতে	ব্যালকনি
ডিজাইনারের	ডিজাইনার
মড্যুলেশন	মড্যুলেশন
নিকেতন	নিকেতন
ঝাড়ফুঁক	ঝাড়ফুঁক
খেয়ে	খেয়ে
আনন্দকে	আনন্দ
পাঠ্যপুস্তকে	পুস্তক
সিনড্রোমের	সিনড্রোম
হাড়ে	হাড়
অংশগুলিতে	অংশ
গ্রেটেল	গ্রেটেল
হারল	হার
মপরায়ণতা	পরায়ণ
ছদ্ম	ছদ্ম
চারেক	চার
ধরতেই	ধরতে
যাবর	যাবর
বাচ্চাকে	বাচ্চা
রাব্বিকে	রাব্বি
অভিবাসীর	অভিবাসী
রোহিঙ্গা	রোহিঙ্গা
শিশির	শিশির
সংখ্যাগরিষ্ঠ	সংখ্যাগরিষ্ঠ
ছুড়তে	ছুড়তে
শতবর্ষী	শতবর্ষী
রগামী	রগ
রাজীবকে	রাজীব
পরামর্শকের	পরামর্শ
সংস্করণও	সংস্করণ
প্যাডাল	প্যাডাল
হাঙ্গেরীর	হাঙ্গেরী
লেপ্টনের	লেপ্টন
ব্যথা	ব্যথা
সঠিকতা	সঠিক
যীশুই	যীশু
মাহফিল	মাহফিল
মারাঠাদের	মারাঠা
মাওবাদী	মাওবাদ
রেখ	রেখ
বিরোধ	রোধ
নিরাপদে	পদ
তারাতারি	তারাতারি
পোষ্য	পোষ্য
জ্বালাতন	জ্বাল
নিয়ন্ত্রণাধীন	নিয়ন্ত্রণ
পরিবর্তনটি	পরিবর্তন
স্ট্রিপ	স্ট্রিপ
ভাষাও	ভাষা
মুক্তিসংগ্রাম	মুক্তি
স্প্যানিশে	স্প্যানিশ
বিষয়গুলিতে	বিষয়
দেশগুলোকে	দেশ
প্রতিকৃতিতে	প্রতিকৃতি
ওয়ার্ল্ড	ওয়ার্ল্ড
রাইজিং	রাইজিং
ফাতেমাকে	ফাতেমা
মুদ্রানীতি	মুদ্রা
বস্তুগতভাবে	বস্তু
চৌম্বকীয়	চৌম্বক
ফরহাদ	ফরহাদ
গণিতিবিদ	গণিতিবিদ
ষোলোয়	ষোলো
যতিত	যতি
হাওয়াই	হাওয়াই
বোরিং	বোরিং
হৃদরোগে	হৃদ
পয়দা	পয়দা
কনস্টেবল	কনস্টেবল
ধ্বনি	ধ্বনি
ইফাদ	ইফাদ
আর্মেনিয়	আর্মেনিয়
কপিলের	কপিল
তথাপি	তথা
চারটি	চার
যদু	যদু
ওষুধপত্র	ওষুধ
চাষীর	চাষ
একুশে	একুশ
রোনালদো	রোনালদো
ইতিহাসকে	ইতিহাস
এজলাস	এজলাস
ডায়ার	ডায়ার
নৈরাশ্য	নৈরাশ্য
নবগঙ্গা	নবগঙ্গা
মিট	মিট
চেচিয়াং	চেচিয়াং
চেয়ারম্যানও	চেয়ারম্যান
কাস্টোমার	কাস্টোমার
সিএমসি	সিএমসি
ডেলিভারী	ডেলিভারী
পরিষেবাগুলিতে	পরিষেবা
অরিন	অরিন
চাপা	চাপ
সিম্পসনস	সিম্পসনস
আধুনিকীকরণের	আধুনিক
গ্রাস	গ্রাস
পেন্টহাউস	পেন্টহাউস
কাজটাই	কাজ
অবসরভাতা	অবসর
রোল	রোল
প্রাচীরে	প্রাচীর
এনজয়	এনজয়
তসলিমার	তসলিমা
পূর্ণরূপ	পূর্ণ
আইনপ্রয়োগকারী	আইন
শ্লীলতাহানির	শ্লীলতাহানি
প্রচারমাধ্যম	প্রচারমাধ্যম
বাইচ	বাইচ
অ্যাসোসিয়েটেড	অ্যাসোসিয়েট
গেছ	গেছ
ইন্ডিয়াকে	ইন্ডিয়া
পদতলে	পদ
আইএসআইএস	আইএস
স্লোভাকিয়ার	স্লোভাকিয়া
ইউনিটে	ইউনিট
মালী	মালী
প্যাকারের	প্যাকার
আহার্য	আহার্য
বিক্রেতাকে	বিক্রেতা
ছিল	ছিল
প্রদাহজনিত	প্রদাহ
নিরাপত্তার	নিরাপত্তা
ইন্সটিটিউটে	ইন্সটিটিউট
মিলিব্যান্ড	ব্যান্ড
কৃপা	কৃপ
বর্ষের	বর্ষ
ফোটাতে	ফোটা
দায়বদ্ধতা	দায়বদ্ধ
মধ্যস্থতাকারীর	মধ্যস্থতাকারী
নবীনের	নবীন
পাঠাত	পাঠাত
এফবিসিসিআই	এফবিসিসিআই
অপরিণত	পরিণত
কালিপদ	কালিপদ
জানবে	জানবে
রত্ন	রত্ন
লোকগানের	গান
পদার্পণ	পদার্পণ
হাপিত্যেশ	হাপিত্যেশ
আবদুন	আবদুন
দামামা	দামামা
ব্ল্যাকবেরি	ব্ল্যাকবেরি
উদ্ভিজ্জ	উদ্ভিজ্জ
স্থাপনকারীদের	স্থাপনকারী
লেভান্ট	লেভান্ট
পত্নীতলা	পত্নী
তমান	তমান
বুঝেছিলাম	বুঝ
বর্গের	বর্গ
জ্যেষ্ঠা	জ্যেষ্ঠ
হতাশ	হতাশ
পরিজন	জন
গ্যাসলাইন	গ্যাস
কালুখালী	কালুখালী
অন্ধ্রপ্রদেশের	অন্ধ্রপ্রদেশ
কল্পনাপ্রসূত	কল্পনা
দেখায়	দেখ
পাপারাজ্জিদের	পাপারাজ্জি
লোপেজের	লোপেজ
সুইটি	সুইটি
কদমা	কদমা
তাইওয়ানে	তাইওয়ান
কোটালীপাড়া	কোটালীপাড়া
স্ত্রীকে	স্ত্রী
খেলোয়াড়দেরকে	খেলোয়াড়
খুবি	খুবি
এনজিওগ্রাম	এনজিওগ্রাম
তওবা	তওবা
বুদ্ধিতে	বুদ্ধি
স্থাপনে	স্থাপন
মার্শ	মার্শ
কেনিয়ান	কেনিয়া
অবদানে	অবদান
বিডিওএসএন	বিডিওএসএন
শ্বাসনালীর	শ্বাসনালী
অযোধ্যার	অযোধ্যা
উত্ত্যক্তের	উত্ত্যক্ত
সমকাম	সমকাম
ফখরুলের	ফখরুল
অনুপ্রবেশের	অনুপ্রবেশ
দুঃখী	দুঃখ
তুষ্টি	তুষ্টি
বধ্যভূমিতে	ভূমি
একান্তই	একান্ত
কসাইখানা	কসাই
খেদমত	খেদমত
পিয়ানো	পিয়ানো
করায়	করা
মারপিঠধর্মী	মারপিঠ
ইতালির	ইতালি
প্রতিনিধিত্বমূলক	প্রতিনিধিত্ব
রুথ	রুথ
এতদসত্ত্বেও	সত্ত্ব
মার্কায়	মার্কা
বিশ্বকে	বিশ্ব
গান্ধী	গান্ধী
উইজডেনের	উইজডেন
বাস্তবতায়	বাস্তবতা
প্রামাণিক	প্রামাণিক
ড্রতে	ড্র
ঘৃণাকে	ঘৃণা
জুকারবার্গ	জুকারবার্গ
দিলেই	দিল
শোক	শোক
অনিরাপদ	নিরাপদ
মালিকানা	মালিক
পূর্বাবস্থায়	পূর্বাবস্থা
অভয়নগর	নগর
নিপতিত	পতিত
গুয়াতেমালা	গুয়াতেমালা
ট্রানজিস্টর	ট্রানজিস্টর
ফার্মি	ফার্মি
লক্ষণের	লক্ষণ
ক্যাপটেন	ক্যাপটেন
কুচার	কুচার
গাভাস্কারের	গাভাস্কার
কুইক	কুইক
কামড়	কামড়
প্রোগ্রেস	প্রোগ্রেস
ব্যবসায়ীকে	ব্যবসা
অস্ট্রেলিয়াও	অস্ট্রেলিয়া
গার্ডস	গার্ডস
আদর্শকে	আদর্শ
লাপ্লাস	লাপ্লাস
তাওবা	তাওবা
এনা	এনা
সংখ্যাযুক্ত	সংখ্যা
জারক	জারক
জিপিএ	জিপিএ
জিপ	জিপ
সদিচ্ছা	সদিচ্ছা
হিন্দুরা	হিন্দুর
ইয়াহিয়া	ইয়াহিয়া
এইতো	এইত
স্রষ্টার	স্রষ্টা
টিক	টিক
যাতে	যা
প্রাপ্তবয়স্ক	প্রাপ্ত
সচিবদের	সচিব
ভোপাল	ভোপাল
সম্পর্কগুলি	সম্পর্ক
মালাইকা	মালাইকা
প্রাণভোমরা	প্রাণভোমরা
অনুষদে	অনুষদ
কর্তার	কর্তা
কভারটি	কভার
লড়বেন	লড়বে
বিয়ারিংয়ের	বিয়ারিং
হ্রাসকারী	হ্রাস
সর্পের	সর্প
তালুতে	তালু
বেলকে	বেল
ইভেন্টগুলি	ইভেন্ট
কামরুলকে	কামরুল
বিশালদেহী	বিশাল
আশাবাদের	আশাবাদ
শক্তপোক্ত	শক্ত
গাছই	গাছ
কনফুসীয়	কনফুসীয়
ঠুনকো	ঠুনকো
সিটিও	সিটিও
শ্বেতা	শ্বেত
ইকোলজি	ইকোলজি
বুলগেরিয়া	বুলগেরিয়া
নাসিরনগরে	নাসিরনগর
প্লাস্টার	প্লাস্টার
পূর্ণহৃদয়ে	পূর্ণহৃদয়
জাকার্তা	জাকার্তা
পক্ষের	পক্ষ
প্যারালিম্পিকে	প্যারালিম্পিক
দৃদ্ধ	দৃদ্ধ
কেন্দ্রীন	কেন্দ্র
দশক	দশ
হত্যাযজ্ঞে	হত্যা
উত্স	উত্স
বইগুলোতে	বই
অতীতকে	অতীত
অন্যন্য	অন্য
পৃষ	পৃ
গোনাহগার	গোনাহগার
মৃতদের	মৃত
আরিফুলের	আরিফুল
উইকিবিশ্ববিদ্যালয়	উইকিবিশ্ববিদ্যালয়
ড্যাশবোর্ড	বোর্ড
পদাধিকারী	পদ
বিজিএমইএ	বিজিএমইএ
ছাড়ল	ছাড়
জনপ্রশাসনে	জনপ্রশাসন
মুক্তিকামী	মুক্তিকামী
ডাকতেন	ডাকত
অল্পস্বল্প	অল্প
ছিন্নবিছিন্ন	ছিন্ন
চার্জার	চার্জ
থমথমে	থমথমে
মুহুর্ত	মুহুর্ত
সার্ভে	সার্ভ
মারমাকে	মারমা
পরিশোধে	পরিশোধ
সিমেন্ট	সিমেন্ট
স্পীড	স্পীড
বইসহ	বই
কিছুক্ষণের	কিছু
সুঠাম	সুঠাম
কৃষিকে	কৃষি
চাইছিলাম	চাইছি
উদ্বুদ্ধ	বুদ্ধ
লেশমাত্র	লেশ
মেটাল	মেটাল
গগলস	গগল
প্রবিধান	প্রবিধান
রেশ	রেশ
চাঁদাবাজিসহ	চাঁদ
বাড়ার	বাড়া
হঠাত	হঠাত
উসমান	উসমান
কুয়েত	কুয়েত
নরেশ	নরেশ
নির্দলের	নির্দল
ক্লিনিকের	ক্লিনিক
সংবাদকর্মীদের	সংবাদকর্মীদের
পিস্টন	পিস্টন
ঠিকই	ঠিক
খেতেন	খেত
শালি	শালি
চাষিদের	চাষি
সত্যতা	সত্য
গোষ্ঠীটি	গোষ্ঠী
শান্তশিষ্ট	শান্তশিষ্ট
আশ্রয়ে	আশ্রয়
রূপায়ণ	রূপায়ণ
বিশ্বজগতের	বিশ্বজগত
সমবায়	সম
এলোয়	এল
যোগ্যতাসম্পন্ন	যোগ্যতা
যুবতীকে	যুবতী
সাংবাদিকরা	সাংবাদিক
তেরো	তেরো
এয়ার	এয়ার
মৌচাক	মৌচাক
নির্দেশাবলীতে	নির্দেশ
নমিনেশন	নমিনেশন
নাদ	নাদ
আত্মস্বীকৃত	আত্মস্বীকৃত
অস্বচ্ছতা	স্বচ্ছ
রাশিদুন	রাশিদুন
দেশভাগের	দেশভাগ
যিরূশালেম	যিরূশালেম
বিক্ষোভকারীরা	বিক্ষোভ
স্ট্রিম	স্ট্রিম
দস্তা	দস্ত
প্রেতাত্মা	প্রেত
ভেক্টরটি	ভেক্টর
কুক্ষিগত	কুক্ষ
সারেন্ডার	সারেন্ডার
নীচের	নীচ
আন্দোলনেও	আন্দোলন
আবহের	আবহ
প্লেসি	প্লেসি
নোটিশের	নোটিশ
পড়বেই	পড়
ট্রাভেল	ট্রাভেল
ভাবব	ভাব
আল্লাহ্	আল্লাহ্
পোয়া	পোয়া
হইতেন	হইত
ছেলেদেরকে	ছেলেদের
উইন্টার	উইন্টার
পরিশ্রমে	শ্রম
একবারই	একবার
উপাদানগুলিতে	উপাদান
ফ্রয়েড	ফ্রয়েড
ইয়াক	ইয়াক
সাপেক্ষে	সাপেক্ষ
ক্রিয়া	ক্রিয়া
হরাইজন	হরাইজন
দুর্যোগে	দুর্যোগ
বাফুফে	বাফুফ
ওয়াটের	ওয়াট
দশমাংশ	দশম
দুমড়ে	দুমড়ে
টিনজাত	টিন
জনের	জন
খাদ্যে	খাদ্য
মৌখিকভাবে	মৌখিক
অন্ধকার	অন্ধকার
ভাগেরই	ভাগের
দশটি	দশ
জেএসএস	জেএসএস
চিতাবাঘের	চিতাবাঘ
বছরজুড়ে	বছর
গাড়ীতে	গাড়ী
লবণের	লবণ
জাহির	জাহির
স্কুলের	স্কুল
প্রজা	প্রজা
গর্বে	গর্ব
সমাজতান্ত্রিক	সমাজ
স্বায়ত্বশাসিত	স্বায়ত্ব
সিএসএস	সিএসএস
অ্যান্টিবায়োটিক	অ্যান্টিবায়োটিক
মুরব্বি	মুরব্বি
অর্জুন	অর্জুন
অগ্নিপরীক্ষা	অগ্নি
ছয়টি	ছয়
ড্রাকুলা	ড্রাকুলা
সমাধি	সমাধি
ফোরের	ফোর
জাফরাবাদ	জাফরাবাদ
অ্যাপার্টমেন্ট	অ্যাপার্টমেন্ট
ক্রিকেটপ্রেমীরা	ক্রিকেট
পদ্ধতির	পদ্ধতি
বার্মিংহাম	বার্মিংহাম
অভিপ্রেত	অভিপ্রেত
গণহত্যায়	গণহত্যা
মত্ত	মত্ত
নিকলে	নিকল
দোররা	দোররা
পাহাড়তলীর	পাহাড়তলী
জোড়াসাঁকোর	জোড়াসাঁকো
নাগরিকতা	নাগরিক
যৌথভাবে	যৌথ
শুভ্র	শুভ্র
ব্যুং	ব্যুং
দুর্গাপূজার	দুর্গাপূজা
সুড়ঙ্গপথ	সুড়ঙ্গ
অসম	সম
রক্তক্ষরণ	রক্তক্ষরণ
কাষ্ঠ	কাষ্ঠ
নিম্নরূপ	রূপ
জলপাইগুড়ি	জলপাইগুড়ি
ময়দা	ময়দা
টাইফুন	টাইফুন
কিংডমের	কিংডম
রকিবউদ্দীন	রকিবউদ্দীন
ফেব্রু	ফেব্রু
চামড়া	চামড়া
লাগার	লাগা
শরিফা	শরিফা
স্বপ্নই	স্বপ্ন
ডায়াগনস্টিক	ডায়াগনস্টিক
স্মরণশক্তি	স্মরণ
মাল্	মাল
উপন্যাসকে	উপন্যাস
পদমর্যাদার	পদমর্যাদা
আসরেই	আসর
কাইয়ুম	কাইয়ুম
সর্বাত্মক	সর্বাত্মক
জামের	জাম
আইস	আইস
ব্রেকিং	ব্রেকিং
অফ্	অফ্
প্রলাপ	প্রলাপ
অফসেট	অফসেট
অ্যাওয়ার্ড	অ্যাওয়ার্ড
অমলিন	মলিন
আন্তঃসম্পর্ক	আন্তঃসম্পর্ক
কর্তৃত্বকে	কর্তৃত্ব
হিসাবরক্ষণ	হিসাব
নিবন্ধীকরণ	নিবন্ধ
শেহজাদের	শেহজাদ
একাংশ	এক
আশকারা	আশ
জোগাড়	জোগাড়
ওয়াশিংটনকে	ওয়াশিংটন
কীর্তিটা	কীর্তি
উকিলের	উকিল
বারাকাত	বারাকাত
দিদি	দিদি
নেতাসহ	নেতা
সিনেট	সিনেট
বিস্কুটের	বিস্কুট
পাঞ্জাবির	পাঞ্জাবি
সাদামাটা	সাদামাটা
জিয়ারত	জিয়ারত
যৌনতাকে	যৌন
কাজগুলোকে	কাজগুলো
মেরাজ	মেরাজ
বিমানচালনা	বিমান
পটে	পট
টিপস	টিপস
সাগরকে	সাগর
রবিনসনের	রবিনসন
ট্রান্সপোর্টের	ট্রান্সপোর্ট
দরদি	দরদি
গলাটা	গলা
ছক্কার	ছক্কা
গয়নার	গয়না
বর্গ	বর্গ
ইভেন্টগুলির	ইভেন্ট
কার্ডের	কার্ড
লন্ড্রি	লন্ড্রি
কাপড়ের	কাপড়
অশ্বেতাঙ্গ	শ্বেতাঙ্গ
এজেন্টরা	এজেন্ট
ঠিকাছে	ঠিক
শিঙা	শিঙা
মাস্	মাস
কারণেই	কারণ
স্বত্ত্ব	স্বত্ত্ব
অংশগ্রহণ	অংশগ্রহণ
ইয়াসমিনকে	ইয়াসমিন
বিদ্রোহীদের	বিদ্রোহ
দিকগুলোর	দিক
অবিচ্ছেদ্য	বিচ্ছেদ
মালিতে	মাল
নোটিশটি	নোটিশ
ঘণ্টার	ঘণ্ট
স্বেচ্ছায়	স্বেচ্ছা
দুর্গাকে	দুর্গা
বোম্বের	বোম্বে
সহীফা	সহীফা
ঘটনাস্থলের	ঘটনাস্থল
কক্ষে	কক্ষ
মায়ে	মা
ছায়াপথসমূহের	ছায়াপথসমূহ
বকশীবাজার	বকশী
আয়ার	আয়ার
যুবলীগের	যুব
স্বজাতির	স্বজাতি
পরিপাক	পরিপাক
ভিডিওটিতে	ভিডিও
মধ্যভাগ	মধ্যভাগ
আবর্তন	আবর্তন
বৈশিষ্ট্যকে	বৈশিষ্ট্য
পায়েল	পা
সাতেক	সাতেক
উদ্যোক্তারা	উদ্যোক্তা
তফাত	তফাত
শিলচরে	শিলচর
পরিষ্কারক	পরিষ্কারক
কামানোর	কামান
ওয়ার্ক	ওয়ার্ক
দেয়	দেয়
শোভনের	শোভন
সাহাবীদের	সাহাবী
কর্মকা	কর্ম
কাচ	কাচ
বরুণ	বরুণ
ব্যায়ামাগারে	ব্যায়াম
কালেব	কালেব
পেস্ট্রি	পেস্ট্রি
নিয়েই	নিয়ে
যভিচার	যভিচার
জনস্টন	জনস্টন
আল্লামা	আল্লামা
উত্সবের	উত্সব
সহযোদ্ধারা	যোদ্ধা
অগ্নিসংযোগের	অগ্নিসংযোগ
জেটি	জেটি
পারুম	পার
নদটি	নদ
নটিক্যাল	নটিক্যাল
মূর্তি	মূর্ত
দর্শকপ্রিয়তা	দর্শক
বিস্ফোরণকে	বিস্ফোরণ
আকুয়া	আকুয়া
গ্রহণীয়	গ্রহণ
ফোটন	ফোটন
খুজে	খুজ
গোবরা	গোবরা
কাজের	কাজ
নির্দ্দোষ	নির্দ্দোষ
যেতে	যেতে
গার্লস	গার্ল
প্লটে	প্লট
রেলিং	রেলিং
শরীরে	শরীর
বিপদেই	বিপদ
উদাসীনতার	উদাসীনতা
উদ্ধারকারীরা	উদ্ধারকারী
সন্ধানের	সন্ধান
সান্তা	সান্তা
আষাঢ়ের	আষাঢ়
জিতবেন	জিত
বালিকাদের	বালিকা
স্কোয়াডের	স্কোয়াড
করিয়ে	কর
তালে	তাল
কার্লটন	কার্লটন
ফাঁড়িতে	ফাঁড়ি
প্রচেষ্টায়	চেষ্টা
বাগদাদি	বাগদাদ
প্যাটিনসনের	প্যাটিনসন
অবস্থায়	অবস্থা
জোহান	জোহান
ফারহান	ফারহান
সাহায্যের	সাহায্য
প্যানের	প্যান
ফাঁকির	ফাঁকি
হরতালকে	হরতাল
বিং	বিং
বিমোচন	বিমোচন
ফাঁসানোর	ফাঁসা
ঝোপে	ঝোপ
প্রথমবারের	প্রথম
কালমেঘা	কালমেঘ
বারোক	বারো
আইপিডিসি	আইপিডিসি
আমিরাতকে	আমি
মুরাদ	মুরাদ
বেতনও	বেতন
বাগিচা	বাগিচা
প্রাইমেট	প্রাইমেট
ধ্বংসলীলার	ধ্বংস
রেইক্	রেইক্
পরিবারগুলোকে	পরিবার
প্রতিরক্ষামন্ত্রীর	প্রতিরক্ষামন্ত্রী
শুটিংও	শুট
মুখপাত্রের	মুখ
শকুনি	শকুন
আলেকজান্দ্রা	আলেকজান্দ্রা
তাজউদ্দীনের	তাজউদ্দীন
মূহূর্তে	মূহূর্ত
খেলোয়াড়	খেলোয়াড়
বিটকয়েনের	বিটকয়েন
চিকিত্সকেরা	চিকিত্সক
নেব	নে
বুদ্ধকে	বুদ্ধ
ভাল	ভাল
টেলিফিল্মের	টেলিফিল্ম
ব্রান্সউইক	ব্রান্সউইক
ভিটামিনের	ভিটামিন
ব্যাপকতা	ব্যাপক
নিম্নচাপটি	নিম্নচাপ
ধারণায়	ধারণা
গ্যাসের	গ্যাস
সূচনাই	সূচন
পদ্ধতিগুলি	পদ্ধতি
কল্পকাহিনীর	কাহিনী
ভেনেসা	ভেনেসা
ট্রেনটির	ট্রেন
ফাঁস	ফাঁস
পোলস	পোলস
হাতড়ে	হাত
কিলোওয়াট	কিলোওয়াট
জানুন	জান
ডলে	ডল
নিরস্ত্র	নিরস্ত্র
স্পিনাররা	স্পিনার
উইকিমিডিয়া	উইকিমিডিয়া
আর্চবিশপ	আর্চবিশপ
আপোষ	আপোষ
ভোরবেলা	ভোর
অন্যকোন	অন্য
হেল	হেল
মিশেছে	মিশেছে
চাপপূর্ণ	চাপ
ফলও	ফল
গাইব	গাইব
বাসকে	বাস
নাতিকে	নাতি
বেঙ্গালুরুতে	বেঙ্গালুরু
ড্রাগস	ড্রাগ
গৃহস্থালির	গৃহ
গবেষণাগার	গবেষণা
সবজান্তা	সব
কানেকটিভিটি	কানেকটিভিটি
শ্লোকে	শ্লোক
ওয়েবে	ওয়েব
পরিবারও	পরিবার
শ্রীনাথ	শ্রীনাথ
রিটার্ন	রিটার্ন
সময়টিতে	সময়
আঙ্গিনা	আঙ্গিনা
ছবিটাই	ছবি
রানীর	রানী
মোল্ড	মোল্ড
রোবটকে	রোবট
সোমবারে	বার
খেলবে	খেল
আরবিতে	আরবি
মার্সেই	মার্সেই
সপ্তায়	সপ্তা
জ্যাকেট	জ্যাকেট
শাশুড়ি	শাশুড়ি
স্খলন	স্খলন
নিখরচায়	নিখরচা
সকালে	সকাল
রেলওয়েকে	রেল
সমবেত	সম
রমজান	রমজান
করীমের	করীম
রেঙ্গুন	রেঙ্গুন
পিপাসার্ত	পিপাসা
পুরস্কারদাতা	পুরস্কার
স্মৃতিস্তম্ভে	স্মৃতি
প্রয়োগকারী	প্রয়োগ
নকশা	নকশা
তোফাজ্জেল	তোফাজ্জেল
ভেষজ	ভেষজ
ভ্যানে	ভ্যান
এলান	এলান
স্ত্রীলোকের	স্ত্রীলোক
ব্রেক্সিটের	ব্রেক্সিট
বৈশিষ্ট্যগুলির	বৈশিষ্ট্য
পুনর্স্থাপনের	পুনর্স্থাপন
এরফান	এরফান
দালানে	দালান
অধিকারই	অধিকার
আফরান	আফরান
ফেব্রুয়ারি	ফেব্রুয়ারি
বাষ্প	বাষ্প
আপনা	আপন
এককাট্টা	এক
ধবংস	ধবংস
প্রস্তাবটি	প্রস্তাব
বাজতেই	বাজ
শোলাকিয়া	শোলাকিয়া
কারাদণ্ড	দণ্ড
ক্ষুণ্ণ	ক্ষুণ্ণ
আত্মা	আত্ম
মাদারীপুর	মাদারীপুর
মুদ্রাঙ্কন	মুদ্রাঙ্কন
ক্যালিফোর্নিয়ায়	ক্যালিফোর্নিয়া
মুরগীর	মুরগী
মিথস্ক্রিয়া	স্ক্রিয়া
সাহিল	সাহিল
শ্লোক	শ্লোক
রপাত	রপাত
শিখন	শিখন
আবিষ্কারকে	আবিষ্কার
সরকারগুলির	সরকার
নাটক	নাটক
পিরানহা	পিরানহা
মারক	মারক
ইউসুফের	ইউসুফ
কোয়েটা	কোয়েটা
প্যারেডের	প্যারেড
দায়দায়িত্ব	দায়িত্ব
জীবনীর	জীবনী
আনুষ্ঠানিকতার	আনুষ্ঠানিকতা
সেরেনা	সেরেনা
দেখছেন	দেখ
ধূলিতে	ধূলি
এডুকেশন	এডুকেশন
গড়ার	গড়া
আফজা	আফজা
পিছে	পিছে
ইনশাল্লাহ	ইনশাল্লাহ
মহানন্দা	মহানন্দ
ডুবোজাহাজ	জাহাজ
সুলতানার	সুলতানা
অজ্ঞ	অজ্ঞ
সিস্কো	সিস্কো
গ্রাফিটি	গ্রাফিটি
বখতিয়ার	বখতিয়ার
মদ্যজাতীয়	মদ্য
হুশিয়ার	হুশিয়ার
খাওয়া	খা
অফিসগামী	অফিস
পরিবেশমন্ত্রী	পরিবেশ
লাবিব	লাবিব
ছোটগল্প	ছোটগল্প
পদার্থ	পদার্থ
গুঁজে	গুঁজ
বাপার	বাপার
নির্ধারণকারী	নির্ধারণ
মিমো	মিমো
মুলার	মুলার
আরএফএল	আরএফএল
খেলছিলাম	খেল
ডেমোক্র্যাটরা	ডেমোক্র্যাট
ফেলে	ফেল
স্বয়ংচালিত	চালিত
অর্গান	অর্গান
অংশসহ	অংশ
প্রভাবের	প্রভাব
লাঘব	লাঘব
আসামী	আসামী
ডিসচার্জ	ডিসচার্জ
রাস্তায়	রাস্তা
ফোটে	ফোটে
আহমদের	আহমদ
অনীক	অনীক
ব্যতিক্রমও	ব্যতিক্রম
বললামঃ	বললাম
বল্লভভাই	বল্লভ
নম্বরপ্লেট	নম্বর
সিদ	সিদ
বন্দীরা	বন্দী
পরানো	পর
হোয়েন	হোয়েন
সেলিব্রেটি	সেলিব্রেটি
সমুচ	সমুচ
ইউক্রেনিয়ান	ইউক্রেন
খাগড়াছড়ি	খাগড়াছড়ি
নোয়া	নোয়া
রুবির	রুবি
দঙ্গল	দঙ্গল
আগরতলায়	আগরতলা
মনসুরের	মনসুর
কাজিন	কাজিন
ঢাকের	ঢাক
ফিক্সিংয়ে	ফিক্সিং
মাছ	মাছ
তিমির	তিমির
এলাহীর	এলাহী
আনন্দপুর	আনন্দপুর
ফাইভে	ফাইভ
নব্বইয়ে	নব্বই
আহলেহাদীছ	হাদীছ
শাইন	শাইন
বয়সসীমা	বয়সসীমা
মিনু	মিনু
সিইসির	সিইসি
বেনিতো	বেনি
তাবলীগ	তাবলীগ
এসএফপি	এসএফপি
মুক্তিপণ	মুক্তিপণ
রেকর্ডকৃত	রেকর্ড
শ্রেষ্ঠা	শ্রেষ্ঠ
দ্বিমিক	দ্বিমিক
স্ত্রীদের	স্ত্রী
সোহম	সোহম
পেলেন	পেল
মিথ	মিথ
চাঁদনী	চাঁদনী
ডিজনির	ডিজনি
ইউএনএইচসিআর	ইউএনএইচসিআর
নাসরি	নাস
জীবনে	জীব
বহনে	বহন
ফ্যাবিও	ফ্যাবিও
ঊর্ধ্বগতি	ঊর্ধ্বগতি
মানবিকতা	মানবিক
কুমারখালীতে	কুমারখালী
ফুঁসে	ফুঁস
খেলুড়ে	খেল
যুগিয়েছেন	যুগ
খিদিরপুর	খিদিরপুর
সশ্রম	সশ্রম
দিকনির্দেশ	দিকনির্দেশ
ডিসপ্লেযুক্ত	ডিসপ্লে
কম্বোডিয়া	কম্বোডিয়া
উইলিয়ামসনের	উইলিয়ামসন
অসিদ্ধতার	সিদ্ধ
তাপসের	তাপস
জাম্বো	জাম্বো
অন্তবর্তী	অন্ত
হাডসন	হাডসন
দ্বারা	দ্বার
অন্তরে	অন্তর
হিমালয়ের	হিমালয়
তাসমানিয়ার	তাসমানিয়া
ন্যায্যমূল্য	ন্যায্য
জেব্রা	জেব্রা
ডিস্কের	ডিস্ক
স্কোরবোর্ড	স্কোরবোর্ড
ভিড়ে	ভিড়
সংস্পর্শের	সংস্পর্শ
ঘুরি	ঘুর
এক্ষেত্রেও	ক্ষেত্র
খালেদুর	খালেদুর
ডালমিয়া	ডালমিয়া
মার্কসবাদী	মার্কস
পড়েনা	পড়
ধূমকেতুর	ধূমকেতু
শিকড়ের	শিকড়
মেট্রোপলিটান	মেট্রোপলিটান
বোমার	বোমা
খুঁজছেন	খুঁজ
বাইসাইকেল	সাইকেল
বোহেমিয়ান	বোহেমিয়ান
অপরাজনীতি	রাজনীতি
হুজুর	হুজুর
শ্রেণীকক্ষ	শ্রেণী
সেলস	সেলস
ভোটাররা	ভোটার
স্টার্লিংয়ের	স্টার্লিং
চিকিৎসকেরা	চিকিৎসক
ডিবিএম	ডিবিএম
রাগে	রাগ
পৌছে	পৌছ
অ্যাডভাইজরি	অ্যাডভাইজর
কষানো	কষা
ইউনিয়নই	ইউনিয়ন
বতর্মানে	বতর্মান
নাগরিকদেরও	নাগরিক
অপব্যয়	অপব্যয়
মাছুম	মাছুম
মাতাপিতার	মাতাপিতা
বজবজ	বজ
স্থাপত্যে	স্থাপত্য
আন্ডার	আন্ডার
দেবদেবী	দেবদেবী
ডপলার	ডপলার
বলছিল	বলছিল
স্ট্যাক	স্ট্যাক
জিয়াকে	জিয়া
ঝুলানো	ঝুলান
মঞ্চ	মঞ্চ
মঙ্গলভাবের	মঙ্গল
রশীদকে	রশীদ
এইডা	এইড
প্রবাহে	প্রবাহ
সৌদিয়া	সৌদি
আইনটির	আইন
তরঙ্গকে	তরঙ্গ
যন্ত্রটি	যন্ত্র
পুরোন	পুরোন
ছাত্রছাত্রীর	ছাত্রছাত্রী
বিরান	বিরান
ফেরি	ফেরি
বীমাকারীর	বীমা
প্রতিষ্ঠাকালে	প্রতিষ্ঠাকাল
সম্মেলনও	সম্মেলন
বৃদ্ধিপ্রাপ্ত	বৃদ্ধি
স্বাধীনতাবিরোধীদের	স্বাধীনতাবিরোধী
স্ম্যাকডাউনের	স্ম্যাকডাউন
দাফন	দাফন
ইন্সটাগ্রামে	ইন্সটাগ্রাম
তবে	তব
ভঙ্গীমা	ভঙ্গী
জব্দের	জব্দ
পরিমল	পরিমল
বাঞ্ছনীয়	বাঞ্ছনীয়
সম্পৃক্তি	সম্পৃক্ত
আখড়ায়	আখড়া
ঠিকঠাকমতো	ঠিকঠাক
ছাড়ে	ছাড়
পাবলিকেশন্স	পাবলিকেশন্স
পরিচালনা	পরিচালন
পরলেও	পরলে
যাত্রাবাড়ীর	যাত্রাবাড়ী
রিজন	রিজন
ডিজেলচালিত	ডিজেল
যোধপুর	যোধপুর
ছালাতের	ছালা
গ্রিডে	গ্রিড
নাহিদ	নাহিদ
দয়া	দয়া
হাসিটা	হাসি
ড্রপ	ড্রপ
অভ্যর্থনা	অভ্যর্থনা
শেকসপিয়রের	শেকসপিয়র
বাসঘাতকতা	ঘাতক
প্রতিযোগিতাটি	প্রতিযোগিতা
প্রাপকদের	প্রাপক
আইভীকে	আইভী
রাজস্বের	রাজস্ব
পরিচয়	পরিচয়
উপার	উপার
কার্যকারিতার	কার্য
লাদেনকে	লাদেন
চেনা	চেনা
মিলসের	মিলস
ট্রেনই	ট্রেন
রসগোল্লা	রস
পারভিনের	পারভিন
আমিরকে	আমির
সালফারের	সালফার
প্রস্তুতের	প্রস্তুত
পারছিস	পারছিস
ইয়াহিয়ার	ইয়াহিয়া
রিও	রিও
হুগো	হুগো
শিক্ষিকা	শিক্ষিক
অনাবৃষ্টি	বৃষ্টি
ধনসম্পত্তি	ধনসম্পত্তি
রচনায়	রচনা
বেপরোয়াভাবে	বেপরোয়া
সিসমিক	সিসমিক
ক্যুরি	ক্যুরি
ফেলি	ফেল
চটকে	চট
হাসিল	হাসি
শেলি	শেলি
মাতারবাড়ী	মাতারবাড়ী
উডি	উড
নাইনের	নাইন
মাথাটি	মাথা
মকলেছুর	মকলেছুর
মাদাম	মাদাম
হইবে	হইবে
হার্লে	হার্লে
চেকআউট	চেক
ওয়াসাকে	ওয়াসা
স্পঞ্জ	স্পঞ্জ
সোমেশ্বর	সোমেশ্বর
বিছিয়ে	বিছিয়ে
হ্রদের	হ্রদ
টিপি	টিপ
দ্যা	দ্যা
ইবাদতে	ইবাদত
উইজডেনে	উইজডেন
টিও	টিও
রেসলিং	রেসলিং
হকিন্স	হকিন্স
হুইপ	হুইপ
সংগীতশিল্পীর	শিল্প
লারমা	লারমা
গুদামঘর	দাম
নেওয়াসহ	নেওয়া
রামকৃষ্ণ	রাম
সর্বজনীনতা	সর্বজনীন
আকর্ষণ	আকর্ষ
রাজকন্যা	রাজকন্যা
শর্তসমূহ	শর্ত
নাইজারের	নাইজার
হাফিজের	হাফিজ
ম্যানেজমেন্ট	ম্যানেজ
বাঁধাধরা	বাঁধা
ভিএইচএফ	ভিএইচএফ
দেল	দেল
সর্বাগ্রে	সর্বাগ্র
রাজনীতিকের	রাজনীতি
রিহ্যাবিলিটেশন	হ্যাবিলিটেশন
রূপান্তরে	রূপান্তর
উবু	উবু
দূষণ	দূষণ
শুটিংয়ের	শুটিং
ঘনিষ্ঠভাবে	ঘনিষ্ঠ
মানবকে	মানব
অনন্তকাল	কাল
বুনিয়াদী	বুনিয়াদ
সঞ্জিত	সঞ্জিত
থাকিও	থাক
ভাষাগুলিতে	ভাষা
আঙিনার	আঙিনা
বড়লোক	বড়লোক
ডেভিলস	ডেভিল
পূর্ব	পূর্ব
নেবেন	নেবে
ক্ষতিতে	ক্ষতি
বাংলাদেশির	বাংলাদেশ
ডেস্কে	ডেস্ক
ব্ক্রা	ব্ক্র
মতি	মতি
পযর্ন্ত	পযর্ন্ত
সিডিউল	সিডিউল
মানচিত্রে	মানচিত্র
কঠোরতা	কঠোর
কতৃপক্ষ	কতৃ
হাজীপুর	হাজীপুর
বিষয়বস্তুর	বিষয়বস্তু
করপোরেশনে	করপোরেশন
রয়েল	রয়েল
আদায়কৃত	আদায়
এসকে	এসকে
শিকড়	শিকড়
কেরানীগঞ্জে	কেরানীগঞ্জ
দুর্দমনীয়	দুর্দমন
নৈপুণ্যের	নৈপুণ্য
উপাচার্য	চার্য
কেন্দ্রেও	কেন্দ্রে
বারবার	বার
নিচতলার	নিচতলা
আনন্দের	আনন্দ
ফাতিমার	ফাতিমা
সাজাইয়া	সাজাইয়া
ভিভ	ভিভ
উন্মত্ত	উন্মত্ত
রচিত	রচিত
চেতনানাশক	চেতনানাশক
মিত্রবাহিনী	মিত্র
মন্ট্রিয়ল	মন্ট্রিয়ল
মহাবিহারের	বিহার
এফএফ	এফএফ
বন্ধনীর	বন্ধনী
ঝান্ডা	ঝান্ডা
সততা	সততা
কাঁঠালের	কাঁঠাল
উচ্চাভিলাষী	উচ্চাভিলাষ
ছাড়	ছাড়
আইনজীবি	আইনজীবি
ওড়িশা	ওড়িশা
ঢালাইয়ের	ঢালাই
বাহারের	বাহার
পীর	পীর
ক্ষতস্থানে	ক্ষতস্থান
পীরগঞ্জে	পীরগঞ্জ
ইয়র্কশায়ারের	ইয়র্কশায়ার
রুপালি	রুপালি
চক্কর	চক্কর
বাক্সটা	বাক্স
টুকিটাকি	টুকিটাকি
নাফিসা	নাফিসা
নর্ড	নর্ড
ফাইলটির	ফাইল
জেন্টেলম্যান	জেন্টেলম্যান
পিচের	পিচ
অঞ্জনা	অঞ্জনা
তিলকরত্নে	তিলকরত্নে
উঠবার	উঠব
রিসর্ট	রিসর্ট
কোণায়	কোণ
টুইট	টুইট
সিয়ামের	সিয়াম
নিজস্ব	নিজ
স্পেসিফিকেসন	স্পেসিফিকেসন
পূর্বাচলে	পূর্বাচল
শামছুর	শামছুর
মনোগ্রাম	মনোগ্রাম
খাচ্ছ	খাচ্ছ
ফাইলগুলির	ফাইল
সামনাসামনি	সামনাসামনি
ঘুরিয়ে	ঘুর
প্রয়াত	প্রয়াত
সহস্র	সহস্র
খাতির	খাতির
কাউয়া	কাউয়া
ফুডস	ফুড
ঢোল	ঢোল
জোয়েল	জোয়েল
মৌসুমীর	মৌসুমী
নাশকতামূলক	নাশকতা
অর্জনকে	অর্জন
মল্লিকার	মল্লিকা
জাদুশিল্পী	জাদু
ক্রিসলার	ক্রিসল
সাইদুরের	সাইদুর
ফ্রায়েড	ফ্রায়েড
প্রধান	প্রধান
ওয়ারিশ	ওয়ারিশ
ব্যক্তিটির	ব্যক্তি
ক্যালিফোর্নিয়া	ক্যালিফোর্নিয়া
যুক্তিবাদী	যুক্তি
ম্যাথুসের	ম্যাথুস
ফ্লাইট	ফ্লাইট
পবিত্রগণের	পবিত্র
গ্রামি	গ্রামি
অর্জনও	অর্জন
ফ্রিডরিখ	ফ্রিডরিখ
ইলাস্ট্রেটর	ইলাস্ট্রেট
হামাদ	হামাদ
জুপিটার	জুপিটার
বয়সটা	বয়স
সংশোধনে	সংশোধন
পাকস্থলীর	পাকস্থলী
রানিগঞ্জ	রানিগঞ্জ
আজাহার	আজাহার
লাগিয়ে	লাগ
ভাষায়	ভাষা
উল্টোপথে	পথ
বদন	বদন
ইত্যাদিসহ	ইত্যাদি
জঙ্গিবাদে	জঙ্গিবাদ
ঘূর্ণিতে	ঘূর্ণিতে
বানচালের	বানচাল
শোনানোর	শোন
উন্নততর	উন্নত
পরতেন	পর
কোপেনহেগেন	কোপেনহেগেন
ঐতিহাসিকরা	ঐতিহাসিক
কবিতাই	কবি
অভিযোগগুলো	অভিযোগ
শার্শা	শার্শা
টুর্নামেন্ট	টুর্নামেন্ট
বিজ্ঞানীর	বিজ্ঞানী
পদচারণ	পদ
উন্মাদনার	উন্মাদ
কষ্টদায়ক	কষ্ট
নিশ	নিশ
কটি	কটি
এমুলেটর	এমুলেটর
কাঠমান্ডু	কাঠমান্ডু
পূত	পূত
এটাকে	এটা
ক্ষুধা	ক্ষুধা
শর্তে	শর্ত
ছত্রাকের	ছত্রাক
গ্রিলে	গ্রিল
বলারও	বলার
ডোজটি	ডোজ
ডাকযোগে	ডাকযোগ
মন্ত্রক	মন্ত্র
জুনায়েদ	জুনায়েদ
দোষী	দোষ
ব্যালটে	ব্যালট
নারীটি	নারী
অ্যাকোয়ারিয়াম	অ্যাকোয়ারিয়াম
বৈশিষ্ট্যসূচক	বৈশিষ্ট্য
ক্ষতিপূরণের	ক্ষতিপূরণ
ক্যাডারে	ক্যাডার
বসতেই	বসতে
কচ্ছপ	কচ্ছপ
দোকানটিতে	দোকান
নিজেরও	নিজের
ডায়মন্ড	ডায়মন্ড
দিকেই	দিক
অগণতান্ত্রিক	গণতান্ত্রিক
ব্যক্তি	ব্যক্তি
ইসরায়েলকে	ইসরায়েল
ফ্রেমটি	ফ্রেম
ভেন	ভেন
দ্রব্য	দ্রব্য
পেরেই	পেরে
ডারউইনের	ডারউইন
মিল	মিল
কেন্দ্রেই	কেন্দ্র
মুজাহিদের	মুজাহিদ
আবাহনীকে	আবাহনী
সমীকরণটি	সমীকরণ
গাঙ	গাঙ
সূর্য্যের	সূর্য
সাতটায়	সাত
আইইডি	আইইডি
প্রহরে	প্রহর
মুফতি	মুফতি
মৌমিতা	মৌমিতা
চেহারাতে	চেহারা
বাড়া	বাড়া
মহাভারতের	মহাভারত
চৌদ্দগ্রামে	চৌদ্দগ্রাম
ক্ষুধায়	ক্ষুধা
অবদানকে	অবদান
শুকনা	শুকনা
ললিতকলা	ললিতকলা
টোলের	টোল
মাদকাসক্তদের	মাদক
চিত্রশালা	চিত্র
ব্র্যান্ডস	ব্র্যান্ড
অদেখা	দেখা
দিচ্ছেন	দিচ্ছ
লালবাগের	লালবাগ
বাজাজ	বাজাজ
আরোগ্যের	আরোগ্য
যন্ত্রপাতি	যন্ত্র
ঝরছে	ঝর
সারে	সারে
শুরুও	শুরু
প্রবাল	প্রবাল
পাপুয়া	পাপুয়া
তাজিকিস্তান	তাজিকিস্তান
লক্ষণও	লক্ষণ
বসুর	বসু
জ্যামিতির	জ্যামিতি
ডাইনামিক	ডাইনামিক
আইসিসিবি	আইসিসিবি
সোফির	সোফি
শারমিনকে	শারমিন
নিয়ন্ত্রণও	নিয়ন্ত্রণ
এডউইন	এডউইন
সরকারগুলি	সরকার
বাংলাবাজার	বাংলা
ইলেক্ট্রিক	ইলেক্ট্রিক
কাব্যগ্রন্থে	কাব্যগ্রন্থ
কাঠামোবদ্ধ	কাঠ
অধিনায়কের	নায়ক
রোহান	রোহান
পছন্দও	পছন্দ
প্রতিপত্তির	প্রতিপত্তি
আলেক্সান্ডার	আলেক্সান্ডার
অধ্যায়টা	অধ্যায়
হিমায়িত	হিমায়িত
মাসকট	মাসকট
ডিগ্রিধারী	ডিগ্রি
রাষ্ট্রযন্ত্রের	রাষ্ট্র
ফোটানো	ফোটানো
কম্পিউটারটি	কম্পিউটার
বিদ্যালয়ঃ	বিদ্যা
ইহাতে	ইহা
চিরকাল	চির
বিলিয়ন	বিলিয়ন
শাহদাত	শাহদাত
রাবেয়ার	রাবেয়া
হেলায়	হেলা
গুলিস্তান	গুলিস্তান
সহপাঠীদের	সহপাঠী
পাকিস্তানভিত্তিক	পাকিস্তান
নদীপথ	নদী
ফিজিশিয়ান	ফিজিশিয়ান
চম্পা	চম্পা
স্নায়বিক	স্নায়বিক
সূর্যের	সূর্য
ইমেল	ইমেল
স্মৃতিশক্তি	স্মৃতি
মৌর্য	মৌর্য
জাঁকজমক	জাঁকজমক
বুয়া	বুয়া
গলায়	গলা
ছায়া	ছায়া
ট্রান্সডুসার	ট্রান্সডুসার
ডিশের	ডিশ
নড়াইল	নড়াইল
স্টারবাকস	স্টারবাকস
সাবস্ক্রিপশন	সাবস্ক্রিপশন
ট্রেনটিতে	ট্রেন
বামহাতে	বামহাত
প্রেশার	প্রেশার
লিবিয়ার	লিবিয়া
সাঙ্গা	সাঙ্গ
আগ্রহও	আগ্রহ
দৃশ্যকে	দৃশ্য
সাঁই	সাঁই
কার্যালয়সহ	কার্যালয়
প্রভাবগুলো	প্রভাব
রচনাটি	রচনা
মাদ্রাসার	মাদ্রাসা
তাজরীনের	তাজরীন
সগির	সগির
বালিশে	বালিশ
সিগারেট	সিগারেট
টীম	টীম
সহকারী	কার
উদদীন	উদদীন
অ্যাপয়েন্টমেন্ট	অ্যাপয়েন্টমেন্ট
যাত্রায়	যাত্রা
পাটজাত	পাট
লুই	লুই
ফলতঃ	ফল
ফিসনেট	ফিসনেট
সুচন্দা	সুচন্দা
ক্রো	ক্রো
পাবলিকেশনস	পাবলিকেশন
প্রকৌশলি	প্রকৌশল
ভার্মার	ভার্মা
ইসমাইলের	ইসমাইল
লীগও	লীগ
নিউইয়র্ক	নিউইয়র্ক
ভিজিটের	ভিজিট
কলব্যাক	কল
যায়সঙ	যায়
তামাটে	তামা
ডালাসে	ডালাস
ছাড়িয়ে	ছাড়
শনিবারে	শনিবার
উপপ্রজাতি	প্রজাতি
পাতিত	পাতিত
সমাজতত্ত্ব	সমাজ
ওসিকে	ওসি
শোকসভা	শোকসভা
মডেলিং	মডেল
ফোম	ফোম
শয়তানের	শয়তান
সঠিক	সঠিক
স্পর্শে	স্পর্শ
দেখিলে	দেখিল
বানর	বানর
পানে	পান
এলাকার	এলাকা
ফুলেফেঁপে	ফুল
মহাদেশীয়	মহাদেশ
বিষয়টিকে	বিষয়
গথিক	গথিক
বিদ্যায়	বিদ্যা
জানালেন	জানা
কস্টিক	কস্টিক
ধরনকে	ধরন
তানজিলা	তানজিলা
পুত্রসন্তান	সন্তান
হাঙ্গার	হাঙ্গার
বিক্রেতা	ক্রেতা
নীতিনির্ধারণে	নীতি
ওয়াইন	ওয়াইন
হতাহতদের	হতাহত
হাইকমিশন	হাইকমিশন
স্কুলসহ	স্কুল
পরিমাপকৃত	পরিমাপ
টেক	টেক
দৃশ্যাবলি	দৃশ্য
নগদে	নগদ
উখিয়ার	উখিয়া
আগাগোড়া	আগাগোড়া
রেঞ্জে	রেঞ্জ
তারিকের	তারিক
দেবু	দেবু
ডিসির	ডিসি
স্থগিতাদেশ	স্থগিত
আমীনের	আমীন
স্থায়ীকরণের	স্থায়ীকরণ
শিক্ষিকাকে	শিক্ষিকা
বন্ধসহ	বন্ধ
আনিসুজ্জামানের	আনিসুজ্জামান
ক্রেওল	ক্রেওল
আজীবনের	আজীবন
সেভিং	সেভিং
কৌতুহলজনক	কৌতুহল
রোজগার	রোজগার
গাজায়	গাজা
তিউনিস	তিউনিস
মূল্যেই	মূল্য
পরিমাণগত	পরিমাণ
সিদ্ধান্ত	সিদ্ধান্ত
ইস্পাতের	ইস্পাত
গম্বুজবিশিষ্ট	গম্বুজ
ফোসকা	ফোসকা
কাউসার	কাউসার
ধিমানদের	মান
ফিশিং	ফিশিং
ভাস্কর্যটি	ভাস্কর্য
সময়টা	সময়
বিদ্যুত্	বিদ্যুত
প্লাবনভূমির	প্লাবনভূমি
হ্যাভ	হ্যাভ
আদালতই	আদালত
কেডস	কেডস
ডিঙ্গি	ডিঙ্গি
ওয়েস্টার্ন	ওয়েস্ট
ফ্রী	ফ্রী
মন্দিরে	মন্দির
লীনা	লীন
বন্দিত্বে	বন্দিত্ব
শাখাগুলি	শাখা
বিক্রিও	বিক্রি
লেখা	লেখা
সবরকম	সবরকম
চট্টগ্রাম	চট্টগ্রাম
টার্বাইন	টার্বাইন
গণবিক্ষোভ	বিক্ষোভ
সাহসিকতায়	সাহস
বুলগেরিয়ার	বুলগেরিয়া
তন্ন	তন্ন
নসরুল	নসরুল
জানিয়েও	জানিয়ে
জড়িয়ে	জড়ি
তোমাদেরই	তোমাদের
ধারণ	ধারণ
গণঅভ্যুত্থানে	অভ্যুত্থান
নির্বাহীদের	নির্বাহ
অবস্থাই	অবস্থা
পৃষ্ঠায়	পৃষ্ঠা
তাড়াতাড়িই	তাড়া
ফিউজ	ফিউজ
হেক্টরের	হেক্টর
সরকারেরও	সরকার
ফরৌণের	ফরৌণ
অসীম	অসীম
মাইকিং	মাইকিং
আত্মপ্রকাশের	প্রকাশ
অমতে	মত
ক্রিস্টির	ক্রিস্ট
মলদ্বার	মল
চাঁপাই	চাঁপাই
ঢাকাতে	ঢাকা
বাথের	বাথের
অর্ডারগুলি	অর্ডার
জবাবের	জবাব
জেমস্	জেমস্
নিয়ন্ত্রিত	নিয়ন্ত্রিত
সাধ্য	সাধ্য
প্রিয়জনের	প্রিয়
ভয়ঙ	ভয়
টাটা	টাটা
শমী	শমী
ম্যালফয়	ম্যালফয়
ওশেন	ওশেন
শরম	শরম
কারিম	কারিম
উদ্দীপনামূলক	উদ্দীপনা
দুর্ভাগ্যজনক	দুর্ভাগ্য
শিশুটিকে	শিশু
লিডস	লিড
উত্তরাধিকার	উত্তরাধিকার
এক্সপেরিমেন্ট	এক্সপেরিমেন্ট
সমালোচক	সমালোচক
আরউইন	আরউইন
মুশরিকরা	মুশরিক
মার্টেজ	মার্টেজ
সামাল	সামাল
পায়	পায়
বাসিন্দারা	বাসিন্দা
বিজলি	বিজলি
লেপের	লেপ
ইলেক্ট্রিক্যাল	ইলেক্ট্রিক্
দেস	দেস
মোদ্দাকথা	মোদ্দাকথা
পাল্প	পাল্প
শ্রীলঙ্কাকে	শ্রীলঙ্কা
আইডিসির	আইডিসি
অধিকাংশই	অধিক
ডিস্ট্রিক্টসের	ডিস্ট্রিক্টস
জীবনীশক্তি	জীবনীশক্তি
গণমাধ্যমকে	গণমাধ্যম
রশান	রশান
দলটিই	দল
মারধরও	মার
কুমারের	কুমার
উদ্ঘাটন	উদ্ঘাটন
হাতকড়া	হাতকড়া
শেখাচ্ছেন	শেখাচ্ছে
বিবাদী	বাদী
নুনের	নুন
নিঃস্বার্থ	স্বার্থ
টিএসি	টিএসি
মালিবাগের	মালিবাগ
জীববৈচিত্র্যের	জীববৈচিত্র্য
ছিপি	ছিপ
স্থানেই	স্থান
সুরার	সুরা
ইউনিকোডে	ইউনিকোড
ডিআইইউ	ডিআইইউ
সত্যিকারভাবে	সত্য
বন্দী	বন্দী
পৌরসংস্থা	সংস্থা
কেলভিনের	কেলভিন
চেনাতে	চেনা
উদ্ভব	উদ্ভব
আন্দ্রে	আন্দ্রে
তরুণ	তরু
দাঁড়ানো	দাঁড়ান
আনলেন	আনল
ক্ষুণ্ন	ক্ষুণ্ন
প্রভাবই	প্রভাব
নিউটনের	নিউটন
অব্যহত	অব্যহত
মুমু	মুমু
ধীরেন্দ্র	ধীরেন্দ্র
খণ্ডের	খণ্ড
আঁশযুক্ত	আঁশযুক্ত
কারণও	কারণ
কুয়াকাটায়	কুয়াকাটা
হস্তান্তরযোগ্য	হস্তান্তর
আখিরাত	আখিরাত
আর্সেনালকে	আর্সেনাল
ইস্রায়েলীয়দেরকে	ইস্রায়েল
খবরের	খবর
পণ্যে	পণ্য
দেবে	দে
একচেটিয়া	একচেটিয়া
রসায়ন	রসায়ন
বাহিনীসমূহ	বাহিনী
জুতায়	জুতা
এপিক	এপিক
ক্রয়কৃত	ক্রয়
আত্মীয়স্বজন	আত্মীয়
কেরামত	কেরামত
ঋতু	ঋতু
আলোকপাত	আলোকপাত
সিএসপি	সিএসপি
এগুলোই	এগুলো
ততটাই	ততটা
সহপাঠীর	সহপাঠ
পক্ষকে	পক্ষ
ছিটমহলের	মহল
যুদ্ধবন্দীদের	যুদ্ধ
পথেও	পথ
তাহ্	তাহ্
চল্লিশের	চল্লিশ
আত্মাতে	আত্মা
ক্রিকেটই	ক্রিকেট
সুরক্ষামূলক	সুরক্ষা
অ্যাপ্লিকেশনটিতে	অ্যাপ্লিকেশন
কলেজশিক্ষক	কলেজশিক্ষক
মল্লিক	মল্লিক
বৈঠকখানা	বৈঠক
দাঁড়ানোর	দাঁড়া
চরিত্রটি	চরিত্রটি
ষায়	ষায়
সহজীকরণ	সহজ
ডাকতে	ডাক
অ্যাটাচমেন্ট	অ্যাটাচমেন্ট
খেলতেও	খেলত
বেসড	বেস
জমেছে	জমেছে
পশ্চিমাঞ্চলীয়	পশ্চিমাঞ্চল
দিনবদলের	দিনবদল
নিয়মিতভাবে	নিয়মিত
ভাবখানা	ভাব
মূলধনি	মূলধন
প্রতিকূল	প্রতিকূল
দেখিয়েছি	দেখিয়েছি
হামিদা	হামিদা
ছাত্ররাও	ছাত্র
যৌগ	যৌগ
পিওএস	পিওএস
এলিয়েন	এলিয়েন
জননেতা	নেতা
অ্যাসোসিয়েশন	অ্যাসোসিয়েশন
বনমোরগ	মোরগ
ঘরবাড়ি	ঘর
কাগজের	কাগজ
জানালার	জানালা
অধিপতি	অধিপতি
গন্ধহীন	গন্ধ
হাওড়	হাওড়
আব্বাসীয়	আব্বাস
সলোমনের	সলোমন
কণ্ঠকে	কণ্ঠ
হিন্দিতে	হিন্দি
পোর্টম্যান	পোর্টম্যান
স্বল্পোন্নত	স্বল্প
পরিচ্ছন্নতার	পরিচ্ছন্ন
গাদাগাদি	গাদাগাদি
বীরের	বীর
বিশ্বচ্যাম্পিয়ন	বিশ্বচ্যাম্পিয়ন
খন্ডিত	খন্ড
খুলেছিল	খুল
কর্মসূচীতে	কর্মসূচী
পাণ্ডুলিপিটি	পাণ্ডুলিপি
অনুষ্ঠানের	অনুষ্ঠান
বোনেরা	বোন
ফেরিঘাট	ফেরিঘাট
পূজনীয়	পূজনীয়
আমজনতা	আমজনতা
নেত্রীকে	নেত্রী
রেসিডেন্সি	রেসিডেন্স
নৈর্ব্যক্তিক	নৈর্ব্যক্তিক
পেইজে	পেইজ
জনসনের	জনসন
ইংরেজের	ইংরেজ
কাঁদিয়ে	কাঁদ
আলগা	আলগা
রেটেড	রেটেড
ইচ্ছাপূরণ	ইচ্ছা
নন্দীর	নন্দী
ফেরিতে	ফেরি
পোস্টমাস্টার	পোস্টমাস্টার
বাচনভঙ্গি	বাচনভঙ্গি
মিঞা	মিঞা
বিস্ফোরণের	বিস্ফোরণ
পারভীনের	পারভীন
পূর্তিতে	পূর্তি
পরিমাণে	মাণ
ট্যাঙ্কটি	ট্যাঙ্ক
ফারাবী	ফারাবী
আম্পায়াররা	আম্পায়ার
পারাপারের	পারাপার
ড্রামে	ড্রাম
আঁটি	আঁটি
ভিকারুননিসা	ভিকারুননিসা
শুধুমাত্র	শুধুমাত্র
নামলাম	নাম
মুফিদুল	মুফিদুল
সিগার	সিগার
রাশিয়াও	রাশিয়া
হৃদ্রোগ	হৃদ
দিমু	দিমু
লাইনে	লাইন
ভাববার	ভাব
নাহিদা	নাহিদা
গুগলি	গুগলি
হাদীসে	হাদীস
গাদা	গাদা
দিতি	দিতি
বড়শি	বড়শি
পর্যটকদের	পর্যটক
পর্যবেক্ষকেরা	পর্যবেক্ষক
আষ্টেপৃষ্ঠে	আষ্টেপৃষ্ঠে
সরল	সরল
সিমন্সের	সিমন্সের
ফুলকপি	ফুলকপি
অটোমোটিভ	অটোমোটিভ
উপফিল্ড	ফিল্ড
জাতিভেদ	জাতি
আনন্দময়	আনন্দ
চিমনি	চিমনি
রঙ্গীন	রঙ্গীন
উন্নত	উন্নত
কুসংস্কারাচ্ছন্ন	কুসংস্কার
হোল্ডারের	হোল্ডার
এতো	এত
চাউলের	চাউল
ডিলারশিপ	ডিলার
স্ক্রিনের	স্ক্রিন
অর্থসংস্থান	অর্থ
যৌনতার	যৌনতা
আহবানকারী	আহবান
স্থিতিশীলতার	স্থিতি
বিপুল	বিপুল
অভিক্ষেপ	অভিক্ষেপ
শিষ্যকে	শিষ্য
শিশুটি	শিশু
ট্যানারি	ট্যানারি
পুষ্পমাল্য	পুষ্প
ব্যারিকেড	ব্যারিকেড
ক্যাফের	ক্যাফে
চিড়িয়াখানা	চিড়িয়া
অনিন্দিতা	অনিন্দিতা
গিয়েছেন	গিয়েছ
আন্দোলনকারীদের	আন্দোলন
যন্ত্রপাতির	যন্ত্রপাতি
বস্তুর	বস্তু
আংশিকভাবে	আংশিক
আকাশ	আকাশ
মাহাতো	মাহাতো
ফুটিয়ে	ফুটিয়ে
অশ্রু	অশ্রু
ওয়ারেন্টি	ওয়ারেন্ট
স্থানীয়দের	স্থানীয়
পয়লা	পয়লা
কাকারা	কাকা
ইউফ্রেটিস	ইউফ্রেটিস
বিজয়নগরের	বিজয়
অভিসন্ধি	সন্ধি
ব্ল্যাকের	ব্ল্যাক
সেজান	সেজান
কনকনে	কনকনে
ঘরছাড়া	ঘর
নাজমুল	নাজমুল
গুণগুলোকে	গুণ
জুটি	জুটি
বাড়ত	বাড়ত
ভীতির	ভীতি
সঠিকরূপে	সঠিক
ধাওয়ায়	ধাওয়া
বিপর্যস্ত	বিপর্যস্ত
প্রশ্নগুলো	প্রশ্ন
রেজোলিউশন	রেজোলিউশন
বাসু	বাসু
অনাদায়ে	অনাদায়
ব্লুটুথের	ব্লুটুথ
রমন	রমন
ঝুল	ঝুল
আছেন	আছ
খেলোয়াড়েরাও	খেলোয়াড়
অর্থনীতির	অর্থনীতি
অভ্যাসটা	অভ্যাস
মহিউদ্দিন	মহিউদ্দিন
ওয়াজ	ওয়াজ
প্রান্তরে	প্রান্ত
চট্রগ্রাম	চট্রগ্রাম
রেনেসাঁ	রেনেসাঁ
ডিএম	ডিএম
মতের	মত
অনুষ্ঠানমালায়	অনুষ্ঠান
বিচারকমণ্ডলীর	বিচারক
লুসিয়াস	লুসিয়াস
সাথি	সাথি
শোনেন	শোন
পেং	পেং
ব্যাচ	ব্যাচ
নামটিই	নাম
সুদীপ্ত	দীপ্ত
হিমালয়ান	হিমালয়
যোগাযোগব্যবস্থা	যোগাযোগ
ওয়াসিম	ওয়াসিম
স্বাস্থ্যসহ	স্বাস্থ্য
ফার্মেসির	ফার্মেসি
ফ্রস্ট	ফ্রস্ট
ভাগ্যটা	ভাগ্যটা
রেক্স	রেক্স
শতক	শত
প্রোডাকশনের	প্রোডাকশন
জনসমর্থনের	জন
ফাঁসাতে	ফাঁসা
প্রতিনিধিও	প্রতিনিধি
কম্পিউটারাইজড	কম্পিউটার
বাধিয়ে	বাধ
গ্রীসের	গ্রীস
বুঝিয়ে	বুঝ
সংশোধন	সংশোধন
পান্না	পান্না
ব্রাহ্মণ	ব্রাহ্মণ
পঞ্চবার্ষিক	বার্ষিক
সেঞ্চুরিই	সেঞ্চুরি
বণ্টনের	বণ্টন
বিদায়	বিদায়
আতংক	আতংক
এবাদত	এবাদত
ফর্ক	ফর্ক
রামায়ণে	রামায়ণ
সৃষ্টিতত্ত্ব	সৃষ্টিতত্ত্ব
সৈনিকরা	সৈনিক
জমায়	জমা
বর্জন	বর্জন
নিয়েছে	নিয়েছ
পোস্টটিতে	পোস্ট
আসিলেন	আসিল
সাজিয়া	সাজিয়া
ফাংশনটির	ফাংশন
ইনকিলাব	ইনকিলাব
আছিয়া	আছিয়া
এলাকাসহ	এলাকা
ঝাঁকাল	ঝাঁকাল
কোরিয়ার	কোরিয়া
নোটেশনাল	নোটেশন
মীরের	মীর
হন্ডা	হন্ডা
উঠছিল	উঠ
নেটওয়ার্ক	নেটওয়ার্ক
ফায়ারফক্স	ফায়ারফক্স
স্বীকৃতির	স্বীকৃতি
স্টকে	স্টক
উচ্চবিদ্যালয়ের	উচ্চবিদ্যালয়
আড়াইটার	আড়াই
মায়ানমারে	মায়ানমার
ভবিষ্যদ্বাণীর	ভবিষ্যদ্বাণী
অনন্যতা	অনন্য
নির্দেশাবলী	নির্দেশ
প্রত্যাশিত	প্রত্যাশিত
প্র্যাকটিসের	প্র্যাকটিস
হিসাবের	হিসাব
অ্যাডাম	অ্যাডাম
ডেনমার্কের	ডেনমার্ক
কালিকাপুর	কালিকাপুর
আপসহীন	আপস
সিরাজউদ্দৌলার	সিরাজউদ্দৌলা
উদ্ধরণ	উদ্ধরণ
নাঈম	নাঈম
নিয়োগপ্রক্রিয়া	নিয়োগ
গোয়াল	গোয়াল
সত্ত্ব	সত্ত্ব
অকৃতজ	কৃতজ
ভারতচন্দ্র	ভারত
মোল্লাসহ	মোল্লা
শিকারীদের	শিকারী
আরফান	আরফান
শরিয়াহ	শরিয়াহ
এসিডদগ্ধ	এসিড
ভরতনাট্যম	ভরতনাট্যম
বিখ্যাত	খ্যাত
ব্যাঙ্কিং	ব্যাঙ্ক
ভালোবাসাও	ভালোবাসা
নির্লিপ্ততা	নির্লিপ্ত
জোটের	জোট
বিমানবন্দরটি	বিমানবন্দর
রাণবন	বন
মাউশির	মাউশ
কেয়ামতের	কেয়ামত
তৃণমূলের	তৃণ
সম্পদকে	সম্পদ
স্বল্পসংখ্যক	স্বল্প
কলেজকে	কলেজ
লোকেশনে	লোকেশন
প্রতারক	প্রতারক
স্কয়ার	স্কয়ার
পসরা	পসরা
ফিস্ট	ফিস্ট
বিরাম	বিরাম
ফায়ারফক্সের	ফায়ারফক্স
খুনিদের	খুনি
জাহাজসমূহ	জাহাজ
পোয়াতী	পোয়াতী
বুঝে	বুঝ
দেখিয়েছ	দেখ
তিনটির	তিন
আর্গুমেন্ট	আর্গুমেন্ট
ওয়ানের	ওয়ান
নাথের	নাথ
উত্তরগুলি	উত্তর
সেকেলে	সেকেল
বিন্দুবৎ	বিন্দু
চিনবে	চিন
সম্পূর্ন	সম্পূর্ন
আয়তন	আয়ত
কার্য্যসাধক	কার্য
অকুপেশনাল	অকুপেশন
মৃত্যুদণ্ডপ্রাপ্ত	মৃত্যুদণ্ড
লূতকে	লূত
ওষুধই	ওষুধ
অহিংসা	হিংসা
জোগাড়ের	জোগাড়
মতপ্রকাশের	মতপ্রকাশ
সফটওয়্যারের	সফটওয়্যার
প্রতিপালন	প্রতিপালন
হরিয়ানার	হরিয়ানা
উৎপাদনের	উৎপাদন
আইএল	আইএল
নির্দেশকের	নির্দেশক
সত্যজিৎ	সত্যজিৎ
চিরশত্রু	শত্রু
একর	একর
সেখানেই	সেখান
শিরোপাটা	শিরোপা
বাবলু	বাবলু
দেশব্যাপী	দেশ
সমরূপ	রূপ
সরাইয়া	সরাইয়া
জিডির	জিডি
জেলাতেই	জেলা
তিস্তা	তিস্তা
লেখাও	লেখ
প্রতিদ্বন্দ্বীদের	প্রতিদ্বন্দ্বী
লেখালেখিতে	লেখ
রয়টার্স	রয়টার্স
গীতিকা	গীতি
পরীক্ষার্থীদের	পরীক্ষা
চিকিৎসাপদ্ধতি	চিকিৎসা
খামার	খামার
টেলিগ্রাফ	টেলিগ্রাফ
ত্রিনিদাদ	ত্রিনি
পারিভাষিক	ভাষিক
এদেশের	দেশ
বেইজিং	বেইজিং
মফিজের	মফিজ
শাড়ির	শাড়ি
আপের	আপে
বানিয়েছিলাম	বানিয়ে
যেকার	যে
বিল্ডিংটি	বিল্ডিং
সমাহিত	সমাহ
নাজনিন	নাজনিন
গ্রান্ড	গ্রান্ড
এতে	এত
সার্বিকভাবে	সার্বিক
ছবিগুলোর	ছবি
গানেই	গান
বিবর	বিবর
শিক্ষার্থীবৃন্দ	শিক্ষার্থী
আখলাক	আখলাক
বেড়ানোর	বেড়ানো
লেপযুক্ত	লেপ
খেয়ালই	খেয়াল
চুলায়	চুলা
পরামর্শক	পরামর্শ
নিবন্ধকরণ	নিবন্ধ
টিএনটি	টিএনটি
ফোর্বস	ফোর্বস
একমেরুসমূহ	একমেরু
ফ্যাশন	ফ্যাশন
রোযা	রোযা
ভাগীরথী	ভাগীরথী
লাবন	লাবন
চক্রান্ত	চক্রান্ত
ওআইসি	ওআইসি
এখনি	এখন
কোর	কোর
প্রেমই	প্রেম
বানানে	বানান
ঘটল	ঘটল
ক্ষেত্রগুলোতে	ক্ষেত্র
শুনলেন	শুনল
হালের	হাল
ম্যানুয়ালি	ম্যানুয়াল
অনুসারেই	অনুসারে
ডিটেকটর	ডিটেকটর
সরতে	সর
ব্যক্তিসহ	ব্যক্তি
মাঠটি	মাঠ
বিষয়গুলো	বিষয়
মোহাম্মদকে	মোহাম্মদ
ইলেকট্রোড	ইলেকট্রোড
নেতাও	নেতা
পিপলস	পিপল
ভেজানো	ভেজ
নায়ারের	নায়ার
পেষকদন্ত	পেষক
ফ্রিল্যান্সারদের	ফ্রিল্যান্সার
দুর্ঘটনাকবলিত	দুর্ঘটনা
কাফেরদের	কাফের
অন্যান্যদের	অন্যান্য
অস্ত্রটি	অস্ত্র
রেটে	রেট
আল্লাহ্র	আল্লাহ্
ছোঁয়া	ছোঁয়া
আফগানরা	আফগান
আবদুল্লাহকে	আবদুল্লাহ
জিগ	জিগ
জিনিসগুলি	জিনিস
আরেকজনকে	আরেকজনকে
যগুলো	যগুলো
শিক্ষাই	শিক্ষা
পাজল	পাজল
রাজ্যগুলোকে	রাজ্য
উপচে	উপচে
সম্ভাবনাকে	সম্ভাবনা
প্রয়োগে	প্রয়োগ
হঠাৎই	হঠাৎ
বংশোদ্ভূত	বংশ
দলীয়ভাবে	দল
সামলাতে	সামল
বৃত্ত	বৃত্ত
ঘুরছে	ঘুর
বলয়	বলয়
রেকর্ডগুলি	রেকর্ড
ভেদাভেদ	ভেদাভেদ
বোধগম্যতাকে	বোধগম্য
ল্যাটেক্স	ল্যাটেক্স
কলেবর	কলেবর
অনুশোচনায়	অনুশোচনা
সংমিশ্রন	মিশ্রন
দিদা	দিদা
ইকোসিস্টেম	ইকোসিস্টেম
সংযোজিত	যোজিত
অভ্যাস	অভ্যাস
স্বকৃত	স্বকৃত
মন্দিরও	মন্দির
যৌনকর্মীরা	যৌনকর্মী
বিবাদীদের	বিবাদ
ইউরেনিয়ামের	ইউরেনিয়াম
পারকিন্স	পারকিন্স
পাঠচক্রের	পাঠ
কারা	কার
টাকাপয়সার	টাকাপয়সা
রিহ্যাব	রিহ্যাব
হালুয়াঘাট	হালুয়াঘাট
স্তুপ	স্তুপ
হাহাকারের	হাহাকার
উমার	উমা
পুত্রবধূর	পুত্রবধূ
কায়দায়	কায়দা
গিটারিস্ট	গিটারিস্ট
ওরিয়েন্টেশন	ওরিয়েন্টেশন
সারাজীবনের	জীবন
পীড়িত	পীড়িত
ট্রাক্টর	ট্রাক্টর
দ্রুতগতিতে	দ্রুত
আদভানি	আদভানি
আলিমের	আলিম
প্রসঙ্গের	প্রসঙ্গ
ডাগআউটে	ডাগআউট
রমজানকে	রমজান
এইচবি	এইচবি
দাড়ান	দাড়ান
মনু	মনু
বিকারগ	বিকার
ইমার্জেন্সি	ইমার্জেন্সি
প্রোটিয়াদের	প্রোটিয়া
পরিচয়ের	পরিচয়
প্রতিদ্বন্দ্বিতামূলক	প্রতিদ্বন্দ্বি
খাদ্যগ্রহণ	খাদ্য
ফ্যাটি	ফ্যাট
হালিমকে	হালিম
টাইপ	টাইপ
ফোল্ডারটি	ফোল্ডার
মুভমেন্ট	মুভমেন্ট
পাঁচগাঁও	গাঁও
শপিংমল	শপিং
সুরাইয়ার	সুরাইয়া
রজতাভ	রজতাভ
দিচ্ছিস	দিচ্ছি
মরিন	মরিন
মুখ্যত	মুখ্যত
খ্রিস্টমাস	খ্রিস্ট
সংগঠনই	সংগঠন
জাতীয়তাবাদের	জাতীয়
তনুজা	তনুজা
রাধার	রাধা
পাপাচারের	পাপ
পর্তুগালে	পর্তুগাল
সিংড়ায়	সিংড়া
চট্টগ্রামের	চট্টগ্রাম
লালপুরে	লালপুর
তালগাছের	তালগাছ
পায়চারি	পায়চারি
এলসিডি	এলসিডি
বাল্টিমোর	বাল্টিমোর
শ্রেণিতে	শ্রেণি
কিলোমিটারে	কিলোমিটার
কেডিই	কেডিই
কোণ	কোণ
কমাবে	কমাবে
মানভেদে	মান
স্ম্যাকডাউন	স্ম্যাক
গীরা	গীরা
স্ট্রোকের	স্ট্রোক
বুদ্ধিজীবী	বুদ্ধি
তুরষ্কও	তুরষ্ক
যোগেশ	যোগেশ
কমান্ডোরা	কমান্ডো
ডিউকের	ডিউক
অ্যানড্রইড	অ্যানড্রইড
বহিরাগতদের	বহিরাগত
বিবাদের	বিবাদ
সেলুনের	সেলুন
উলফ	উলফ
দুর্দান্ত	দুর্দান্ত
পিসিএস	পিসিএস
সংবাদে	সংবাদ
অপ্টিমাইজড	অপ্টিমাইজড
অনুগামীদের	অনুগামী
প্রশিক্ষণপ্রাপ্ত	শিক্ষণ
পৌঁছাল	পৌঁছা
শহীদুল্লাহর	শহীদুল্লাহ
পুবে	পুব
ফটোতে	ফটো
অভ্যন্তরীন	অভ্যন্তর
সন্ত্রাসমুক্ত	সন্ত্রাস
ক্লাইম্বিং	ক্লাইম্ব
পারছে	পারছ
লাফে	লাফ
অনিচ্ছুক	অনিচ্ছু
জড়ালে	জড়
ভিন্নতার	ভিন্নতা
উপলক্ষটা	উপলক্ষ
আর্মিরা	আর্মি
শ্বেত	শ্বেত
অ্যাকাউন্ট	অ্যাকাউন্ট
কাপড়ে	কাপড়
ভাগাড়ে	ভাগাড়
এফএসএফ	এফএসএফ
হুসনে	হুসনে
ভবিষ্যৎই	ভবিষ্যৎ
ইম্পিরিয়াল	ইম্পিরিয়াল
মায়াময়	মায়া
দিয়েছেন	দি
দাদিকে	দাদি
একটিরও	একটি
বেদনাদায়ক	বেদনা
ঝুঁকি	ঝুঁকি
ফ্যালকন	ফ্যালকন
অন্যটির	অন্য
টটেনহাম	টটেনহাম
স্তরবিশিষ্ট	স্তর
মেইলে	মেইল
ফয়সালাবাদ	ফয়সালাবাদ
পরশুরাম	পরশুরাম
ধর্মশাস্ত্র	ধর্মশাস্ত্র
উপায়গুলি	উপায়
ডাইস	ডাইস
নিলামের	নিলাম
পদচারণা	পদচারণা
ডেনিয়েল	ডেনিয়েল
সম্প্রচারকারী	সম্প্রচার
জনবান্ধব	জনবান্ধব
যতক	যতক
ট্রলারের	ট্রলার
বাহারুল	বাহারুল
পশ্চিমবঙ্গ	পশ্চিম
পড়বেন	পড়
দেদীপ্যমান	দেদীপ্য
ভিসির	ভিসি
বহরের	বহর
মধ্যবর্তী	মধ্য
কন্ঠে	কন্ঠ
নিম্নচাপের	নিম্নচাপ
সময়সূচিতে	সময়
ভালা	ভাল
পরাজয়ে	জয়
রাজ্যের	রাজ্য
রেলওয়ের	রেলওয়ে
দৃষ্টান্তমূলক	দৃষ্টান্ত
ধাবক	ধাবক
আত্মবিশ্বাসটা	বিশ্বাস
মালিকরা	মালিক
আবুধাবি	আবুধাবি
খেয়াঘাটে	খেয়াঘাট
প্রতিবেশীকে	প্রতিবেশী
ইকুইটি	ইকুইটি
বার্কলের	বার্কল
রসূলগণের	রসূল
ট্রান্সপোর্টেশন	ট্রান্সপোর্ট
কেঁদেই	কেঁদে
আজকেও	আজকে
শিক্ষার্থীসহ	শিক্ষার্থী
পরমহংস	হংস
নস্টালজিক	নস্টালজিক
পঞ্জিকাবর্ষে	পঞ্জিকাবর্ষ
অসাম্য	সাম্য
আশফাক	আশফাক
বালিগাঁও	বালিগাঁও
সপ্তাহান্তের	সপ্তাহ
বাদশাকে	বাদশা
কাটেন	কাট
অবশিষ্টাংশের	অবশিষ্ট
হলগুলোর	হল
নিকেল	নিকেল
সিনহাকে	সিনহা
বস্তুগত	বস্তুগত
সোলায়মানের	সোলায়মান
গুরুকে	গুরু
লাশে	লাশ
প্রাক	প্রাক
লিভার	লিভার
হাতপাখা	হাতপাখা
প্রবেশদ্বারের	প্রবেশদ্বার
হিউম্যানস	হিউম্যান
ধারণাগুলোর	ধারণা
প্রায়োগিক	প্রায়োগিক
কোয়ান্টিকো	কোয়ান্টিকো
মানবহিতৈষী	মানব
সমর্থনও	সমর্থন
কাতলা	কাতল
দেখেছিলে	দেখেছিল
যক্ষা	যক্ষা
টিলায়	টিলা
পরগণার	পরগণা
আনুষ্ঠানিকভাবে	আনুষ্ঠানিক
সম্পর্কও	সম্পর্ক
প্রত্যাশার	প্রত্যাশা
সর্ম্পক	সর্ম্পক
এগুলোকে	গুলো
বউবাজার	বাজার
জার্নি	জার্নি
হতদরিদ্রদের	দরিদ্র
পডকাস্টে	পডকাস্ট
বিলের	বিল
আদালতে	আদালত
ঘোর	ঘোর
চোরাকারবারিরা	চোর
চন্ডিকা	চন্ডিকা
অতিপ্রাকৃত	প্রাকৃত
রোমানিয়ায়	রোমানিয়া
ইনডেক্স	ইনডেক্স
নুয়ান	নুয়ান
পূর্বনাম	পূর্বনাম
পুনর্বিন্যাসের	পুনর্বিন্যাস
সিলেক্ট	সিলেক্ট
পদাঙ্গুলি	পদাঙ্গুল
থাকেই	থাক
চটকান	কান
সংলাপ	সংলাপ
গ্যারেজের	গ্যারেজ
আপ্তে	আপ্ত
অস্ট্রেলিয়ায়	অস্ট্রেলিয়া
বঙ্গদেশের	বঙ্গদেশ
গোলদাতার	গোলদাতা
ফাজিল	ফাজিল
ওটি	ওটি
অসহায়ভাবে	অসহায়
জিনিসগুলোর	জিনিস
বাড়িটিতে	বাড়ি
মাসুদুর	মাসুদুর
পিউর	পিউর
মতানৈক্যের	মত
ফেরেশতার	ফেরেশতা
শিবলিঙ্গ	শিবলিঙ্গ
ইউনিয়নভুক্ত	ইউনিয়ন
নজরদারি	নজর
আস্থায়	আস্থা
প্রক্রিয়াজাতকরণ	প্রক্রিয়াজাত
শুনলেই	শুনল
অধিরাজ্য	অধিরাজ্য
স্ট্যান্ডিং	স্ট্যান্ড
কেনি	কেনি
ছোটগল্পকার	গল্প
রেনাটা	রেনাটা
ক্রেডিটের	ক্রেডিট
অবয়ব	অবয়ব
সিআইএস	সিআইএস
বিজেপি	বিজেপি
প্রাচীনদেরকে	প্রাচীনদের
ডিভিশন	ডিভিশন
ঠভাবে	ঠভাব
লেয়ার	লেয়ার
হরিচরণ	হরিচরণ
বিলস	বিল
বিতরণকালে	বিতরণকাল
ভবনধসের	ভবনধস
দক্ষতার	দক্ষ
চুনাপাথর	চুনাপাথর
প্রতিযোগীতার	প্রতিযোগীতা
ফলার	ফল
রবে	রব
স্ক্যান্ডিনেভিয়া	স্ক্যান্ডিনেভিয়া
ইস্কাটন	ইস্কাটন
জের	জের
জোগাচ্ছে	জোগাচ্ছে
কেজিতে	কেজি
কিরে	কি
বিবর্ধনের	বিবর্ধন
আকাশে	আকাশ
রথের	রথ
ছড়িয়ে	ছড়ি
ভার্নন	ভার্নন
হয়েই	হয়
পঞ্চমুখ	মুখ
অলিম্পাস	অলিম্পাস
জয়নগর	জয়নগর
কর্ণ	কর্ণ
রেফ্রিজারেটরের	রেফ্রিজারেটর
বন্ড	বন্ড
মুখ্যমন্ত্রীকে	মুখ্য
কালিগঞ্জ	কালিগঞ্জ
ম্যাচকে	ম্যাচ
ইটিভির	ইটিভি
বড্ড	বড্ড
বাহ	বাহ
স্মৃতিসৌধ	স্মৃতি
হ্যাট্রিক	হ্যাট্রিক
বখত	বখত
বিষয়কে	বিষয়
পথপ্রদর্শক	পথপ্রদর্শক
খাইয়েছিলেন	খাইয়েছিল
ভূগোলে	ভূগোল
মুরে	মুর
কেবলি	কেবল
শিলা	শিলা
মোতাবেক	মোতাবেক
প্রণয়নকারী	প্রণয়ন
ফ্রেম	ফ্রেম
ম্যুলার	ম্যুলার
কার্গো	কার্গো
রেন্ডারিং	রেন্ডার
এক্সএক্স	এক্সএক্স
টিউবে	টিউব
শিরায়	শিরা
প্রবণতাও	প্রবণতা
কারিগররা	কারিগর
নির্বাহী	বাহ
বোকামি	বোকামি
নতুনতর	নতুন
অধিকারসহ	অধিকারসহ
পিণ্ড	পিণ্ড
কারুর	কারু
মিডিয়া	মিডিয়া
পূর্বাঞ্চলীয়	পূর্বাঞ্চল
যাওয়ার	যাওয়া
কতবার	কত
তাড়ায়	তাড়া
সোলায়মানের	সোলায়মান
পরিচর্যাকেন্দ্রে	পরিচর্যা
কারোই	কারো
লিঙ্ক	লিঙ্ক
শিশুতোষ	শিশু
পথও	পথ
ভূতত্ত্ব	তত্ত্ব
ডিজিট্যাল	ডিজিট্যাল
স্নিগ্ধ	স্নিগ্ধ
শুক্ল	শুক্ল
লিখবেন	লিখ
ইসলামসহ	ইসলাম
শান্তনু	শান্ত
অ্যাসিডের	অ্যাসিড
রাজকন্যাকে	রাজকন্যা
এজেন্টকে	এজেন্ট
পোশাক	শাক
ভোর	ভোর
অযোগ্য	যোগ্য
ঐশ্বরিয়া	ঐশ্বরিয়া
ছুটির	ছুটি
অধিবাসীদের	অধিবাসী
পাইপলাইনের	পাইপলাইন
কর্মব্যস্ত	কর্ম
গাং	গা
রাডারের	রাডার
ভারতও	ভারত
আঁকি	আঁকি
রুম	রুম
দেশবরেণ্য	দেশ
একশ্রেণির	একশ্রেণির
অ্যাভিনিউয়ের	অ্যাভিনিউ
বর্ণনায়	বর্ণনা
বরপেটা	বর
জারের	জার
বনশ্রীতে	বনশ্রী
ঔষধ	ঔষধ
দলই	দল
অ্যারের	অ্যারে
শীর্ষস্থানীয়	শীর্ষস্থান
জিনিসপত্রের	জিনিসপত্র
গার্ল	গার্ল
মহামহিম	মহিম
মঞ্চায়ন	মঞ্চ
ডেনমার্কে	ডেনমার্ক
রুটস	রুট
যৌনপল্লির	যৌন
রাজনীতিই	রাজনীতি
মুত্তালিব	মুত্তালিব
মুখচ্ছবি	মুখচ্ছবি
চলচ্চিত্রের	চল
দেহি	দেহি
অনুরোধেই	অনুরোধ
ট্রাফিকের	ট্রাফিক
পূর্ববিরোধের	পূর্ববিরোধ
আইনগুলি	আইন
কাটাতে	কাট
অ্যাসিটিক	অ্যাসিট
কানেক্টিভিটি	কানেক্টিভিটি
কৃতকার্য	কৃতকার্য
পত্রিকাকে	পত্রিকা
নাসেরের	নাসের
সহকারীর	সহকারী
হেরে	হেরে
বিক্রমপুরের	বিক্রমপুর
ইনভেন্টরি	ইনভেন্টরি
দিকে	দিক
বিভিন্নতা	ভিন্ন
ছোট্ট	ছোট্ট
কোরবানির	কোরবানি
কুয়াকাটার	কুয়াকাটা
পরীক্ষামূলক	পরীক্ষা
স্বশিক্ষিত	স্বশিক্ষিত
শহরটিকে	শহর
সংক্রান্তির	সংক্রান্তি
ক্ষতবিক্ষত	ক্ষত
সীফুড	ফুড
কথাবার্তার	কথাবার্তা
পর্যায়ে	পর্যায়
হাজেরার	হাজেরা
কবি	কবি
সফটওয়্যারটি	সফটওয়্যার
আত্না	আত্না
প্রাইমারী	প্রাইমারী
অভিজ্ঞতালব্ধ	অভিজ্ঞ
জেলেরা	জেলে
খেলাই	খেলা
মাতামাতি	মাতামাতি
সেফটি	সেফ
সদস্যগণের	সদস্য
থামছে	থামছে
জবসের	জবস
পরিকল্পনাই	পরিকল্পনা
বিজয়ীদের	বিজয়
ভিয়েত	ভিয়েত
রিকশাকে	রিকশা
পর্বতারোহণের	পর্বতারোহণ
স্টকিংস	স্টক
পাগলাটে	পাগল
যুক্তিসঙ্গত	যুক্তি
স্প্যাশিয়ালভাবে	স্প্যাশিয়াল
অতিরিক্ত	অতিরিক্ত
সাফে	সাফ
এফডি	এফডি
পাঠিয়েছ	পাঠিয়ে
প্রকৌশলী	কৌশল
এরিয়া	এরিয়া
এগোয়নি	এগোয়নি
ট্যাগটি	ট্যাগ
সামিটে	সামিট
খ্রীষ্টধর্ম	খ্রীষ্টধর্ম
সমঅধিকার	অধিকার
অনের	অন
যুকে	যুক
কেনইবা	কেন
নবনির্মিত	নির্মিত
আফগান	আফগান
শাহজাহানপুরে	শাহজাহানপুর
এজেন্ট	এজেন্ট
পারফর্মেন্স	পারফর্মেন্স
ওয়েবসাইটগুলোতে	ওয়েবসাইট
নোভা	নোভা
অরুন	অরুন
টোটকা	টোটকা
শরিয়তের	শরিয়ত
লাপাত্তা	লাপাত্তা
মফিজ	মফিজ
শ্রমমন্ত্রী	মন্ত্রী
স্লোগানে	স্লোগান
শোভাযাত্রার	শোভাযাত্রা
অ্যাডভেঞ্চার	অ্যাডভেঞ্চার
পিনাট	পিনাট
ঝিনুকের	ঝিনুক
স্ট্যাটর	স্ট্যাটর
প্রস্থানের	প্রস্থান
ইলেকট্রনিক্সের	ইলেকট্রনিক্স
মাহিরা	মাহিরা
কিডনী	কিডনী
পদবিন্যাস	পদ
গ্রীসে	গ্রীস
নাসরিন	নাস
বালুমহালের	বালুমহাল
খরচা	খরচ
খানাতের	খানাত
পপুলেশন	পপুলেশন
বিভাগটি	বিভাগ
বগুড়ার	বগুড়া
বলিতে	বলি
পক্ষপাতহীন	পক্ষপাত
প্রহ্লাদ	প্রহ্লাদ
সিএন	সিএন
চিরাচরিত	চিরাচরিত
মঙ্গলবার	মঙ্গল
যোগসাজশে	সাজশ
রুপালী	রুপালী
অভয়ারণ্যের	অভয়ারণ্য
নড়ে	নড়ে
নাইজেল	জেল
আরএমএস	আরএমএস
তামজিদ	তামজিদ
অপেক্ষাটা	অপেক্ষা
বামপন্থী	বামপন্থী
লাচ্ছি	লাচ্ছি
করনীয়	করনীয়
জাতিসমূহের	জাতি
কিসমত	কিসমত
প্রেরকের	প্রেরক
জন্মদিনকে	জন্মদিন
মখমলের	মখমল
তেঁতুলিয়া	তেঁতুলিয়া
হেপাটাইটিস	হেপাটাইটিস
রিচার	রিচা
সত্যায়িত	সত্য
ফরহাদকে	ফরহাদ
সিনেমাটোগ্রাফি	সিনেমাটোগ্রাফি
ভাব	ভাব
গিলোটিন	গিলোটিন
ব্যান্ডউইথের	ব্যান্ডউইথ
ফ্ল্যাটে	ফ্ল্যাট
বিওপি	বিওপি
অনেকের	অনেক
দেশগুলোর	দেশ
সহায়তাকারী	সহায়তা
রাবাব	রাবাব
শিল্পাঞ্চলে	শিল্প
ছাড়বে	ছাড়
হিসাবও	হিসাব
কলটি	কল
কোনটিতে	কোন
স্বার্থেই	স্বার্থে
উচ্ছেদে	উচ্ছেদ
ভুটানি	ভুটান
তরিকুলের	তরিকুল
অন্ধের	অন্ধ
খুঁজছিলেন	খুঁজ
স্বার্থরক্ষার	স্বার্থরক্ষা
সন্মানিত	সন্মানিত
কলুষতার	কলুষতা
ছলতা	ছল
রাউন্ডেই	রাউন্ডে
কুমীর	কুমীর
কাস্টম	কাস্টম
লিখেও	লিখ
পাত্রকে	পাত্র
সত্তরের	সত্তর
থানা	থানা
আয়েশা	আয়েশা
শিবলি	শিবলি
প্রথমবার	প্রথম
বলই	বল
ভেবো	ভেবো
রক্তাক্ত	রক্ত
মুদ্রাগুলো	মুদ্রা
সরদার	সরদার
রুগ্ণ	রুগ্ণ
আবাদী	আবাদী
গণনার	গণনা
সর্পিল	সর্পিল
সংগীতজ্ঞ	সংগীত
পিতৃ	পিতৃ
অংশীদারদের	অংশীদার
ড্রইং	ড্রইং
বাকী	বাকী
যেটিতে	যেটি
বগি	বগি
মুলতানে	মুলতান
বৈসাদৃশ্যে	সাদৃশ্
বাহরাইন	বাহরাইন
পারস্যের	পারস্য
মাপক	মাপ
ফরেন	ফরেন
আক্রোশে	আক্রোশ
উয়েফার	উয়েফা
সরকারিভাবে	সরকার
ব্যাঙ্ক	ব্যাঙ্ক
জসিমউদ্দিন	জসিমউদ্দিন
তিলে	তিল
চ্যাম্পিয়নশিপ	চ্যাম্পিয়ন
হার্মিস	হার্মিস
তপথ	তপথ
চাট	চাট
ইয়েমেনের	ইয়েমেন
তরিকুল	তরিকুল
জেমি	জেমি
স্থলে	স্থল
কুটিরের	কুটির
মনোযোগী	মনোযোগ
হ্যাকিংয়ের	হ্যাক
বেহালার	বেহালা
অর্থবছরে	অর্থবছর
বিপাকের	বিপাক
সম্মেলনের	সম্মেলন
বেতারের	তার
নির্মাতা	নির্মাতা
ট্র্যাশ	ট্র্যাশ
হুয়াউয়ে	হুয়াউয়
গুরুরা	গুরু
চোয়াল	চোয়াল
অ্যাণ্ড	অ্যাণ্ড
সেনারা	সেনা
যান	যা
জনসমক্ষে	জনসমক্ষ
গর্বাচেভ	গর্ব
অব্দের	অব্দ
ডুমুর	ডুমুর
আন্তর্জাতিক	আন্তর্জাতিক
জেএসডি	জেএসডি
আদমশুমারিতে	আদমশুমারি
জানিয়েছি	জানিয়ে
বিশ্বাসযোগ্যতার	বিশ্বাস
সম্প্রচারে	সম্প্রচার
পক্ষপাতমূলক	পক্ষপাত
আর্চি	আর্চি
ম্যাকগিল	ম্যাকগিল
অনলাইনেই	অনলাইন
বুঝিয়েছে	বুঝিয়েছ
জুড়ীতে	জুড়ী
ভালোবাসত	ভালোবাসত
বয়লারের	বয়
মেহেন্দীগঞ্জ	মেহেন্দীগঞ্জ
স্ত্রীলোকেরা	স্ত্রী
ছফা	ছফা
প্রকল্পে	প্রকল্প
দ্রাবিড়ের	দ্রাবিড়
স্টেশনগুলির	স্টেশন
মঞ্চের	মঞ্চ
স্ট্রাকচার	স্ট্রাকচার
রকেটের	রকেট
কেন্দ্রটিতে	কেন্দ্র
ত্রিভুজাকার	ত্রিভুজ
্যাপিড	্যাপিড
অনুষ্ঠানরত	অনুষ্ঠান
কোনদিনই	কোনদিন
সফর	সফর
কাগজগুলো	কাগজ
মনসুর	মনসুর
মধ্যপ্রাচ্যে	প্রাচ্য
আলভি	আলভি
লক্ষী	লক্ষী
প্রসেসরে	প্রসেসর
কার্যাবলি	কার্য
ফেরেননি	ফের
ডিভোর্স	ডিভোর্স
সিরোসিস	সিরোসিস
বাদলের	বাদল
ফুটবলপ্রেমীরা	ফুটবলপ্রেমীরা
স্ট্যাম্পিং	স্ট্যাম্পিং
পোড়	পোড়
ব্রহ্মচর্য	ব্রহ্ম
হ্যানোভার	হ্যানোভার
প্লটের	প্লট
আত্মীয়স্বজনেরা	আত্মীয়স্বজন
শিশুরা	শিশু
দিকনির্দেশনা	দিকনির্দেশনা
সুরজিত	সুরজিত
বার্লিনে	বার্লিন
বাসগৃহে	বাসগৃহ
পাতানোর	পাতানো
দিবারাত	রাত
প্রভিন্সিয়াল	প্রভিন্স
চক্রের	চক্র
নাম	নাম
বায়ান	বায়ান
সম্পদও	সম্পদ
কমলাপুরের	কমলাপুর
পণ্ড	পণ্ড
ঝাপটায়	ঝাপটা
মানুষগুলোর	মানুষ
জজকোর্ট	কোর্ট
পড়ো	পড়ো
উদিত	উদিত
ভুতের	ভুত
লেবীয়	লেবী
দক্ষিণবঙ্গের	দক্ষিণ
এসোসিয়েশন	এসোসিয়েশন
চায়	চা
অস্ত্রধারী	অস্ত্র
এলজি	এলজি
রয়্যালসের	রয়্যাল
নিম্নমানের	নিম্ন
কমনীয়	কমন
কট্টরপন্থী	কট্টর
ঘামে	ঘাম
বয়ঃসন্ধির	বয়ঃসন্ধি
শ্রেণিকক্ষে	শ্রেণিকক্ষ
শ্রীরামপুরের	শ্রীরামপুর
ভাষ্যের	ভাষ্য
তারিখটা	তারিখ
থামে	থাম
সংস্থায়	সংস্থা
সময়টি	সময়
বিদ্যুতায়ন	বিদ্যুত
পারাপার	পারাপার
ক্যাবল	ক্যাবল
হাকাম	হাকাম
বিয়ে	বিয়ে
কিসের	কিসে
অভিহিত	হিত
উড়ে	উড়
চিক্চিক	চিক্চিক
দুবছর	দুবছর
মহানদী	নদী
আলভেজ	আলভেজ
বঙ্গভঙ্গ	বঙ্গভঙ্গ
গৃহযুদ্ধ	যুদ্ধ
ছাড়ব	ছাড়
সম্রাজ্যের	সম্রাজ্য
আইপিজি	আইপিজি
শফিকুর	শফিকুর
ফিকশন	ফিকশন
বন্দরকে	বন্দর
কিঞ্চিৎ	কিঞ্চিৎ
মেইডেন	মেইডেন
বলতঃ	বল
সুরা	সুরা
বাছাইগুলো	বাছাই
অনুকরণে	অনুকরণ
মাকসুদুল	মাকসুদুল
কোঠার	কোঠা
এলির	এলি
প্লেটের	প্লেট
ঢাকায়ও	ঢাকা
উর্বরতা	উর্বর
চেয়েছিলেন	চেয়েছিলেন
ইহকাল	ইহকাল
চালাচ্ছিলেন	চাল
আজারবাইজানি	আজারবাইজান
সমাবেশস্থলে	সমাবেশ
বাধল	বাধ
গ্রামের	গ্রাম
কুঁকড়ে	কুঁকড়ে
সিজিপিএ	সিজিপিএ
সন্তানাদি	সন্তান
পেশাদারিত্ব	পেশা
রেডমি	রেডমি
বাশ	বাশ
সম্পদগুলো	সম্পদ
পরীক্ষাতে	পরীক্ষা
এক্সিলেন্স	এক্সিলেন্স
মশীহের	মশীহ
সখীপুরের	সখীপুর
সম্প্রসারন	সম্প্রসারন
নিয়ন্ত্রক	নিয়ন্ত্রক
রঙের	রঙ
মিলেছে	মিল
মানেন	মানে
হিলি	হিলি
অ্যাটলান্টিক	অ্যাটলান্টিক
পয়জন	জন
কানপুরের	কানপুর
করো	কর
লাগামহীন	লাগাম
বুন্দেসলিগা	বুন্দেসলিগা
বাগমারায়	বাগমারা
ব্রোশারের	ব্রোশার
সিপিএম	সিপিএম
গোপনে	গোপন
রায়হান	রায়হান
এমডিজির	এমডিজি
দোয়েলের	দোয়েল
ধারণাগুলির	ধারণা
পূরণকল্পে	পূরণকল্প
খ্রীষ্টীয়জগতের	খ্রীষ্ট
আজ্ঞা	আজ্ঞা
স্মৃতিচারণ	স্মৃতিচারণ
দেওবন্দী	বন্দী
আগ্রহ	গ্রহ
লড়াকু	লড়াকু
জিন্নাত	জিন্নাত
উপনিবেশে	উপনিবেশ
অ্যাকাডেমি	অ্যাকাডেমি
অনুচ্ছেদ	অনুচ্ছেদ
সাংবাদিকতায়	সাংবাদিক
টিবি	টিবি
টিপু	টিপু
ফোরামের	ফোরাম
ঝিলিমিলি	ঝিলিমিলি
লিংক	লিংক
সিহাব	সিহাব
পল্টু	পল্টু
স্টার্টআপ	স্টার্টআপ
দুনিয়াতেই	দুনিয়া
ফিতনা	ফিতনা
লাফার্জ	লাফার্জ
জন্মনিয়ন্ত্রণ	জন্ম
স্কোরবোর্ডের	স্কোরবোর্ড
ধিমানগণ	ধিমান
বয়স্ক	বয়স্ক
নাদিয়ার	নাদিয়া
এরদোয়ান	এরদোয়ান
ভবিষ্যতবাণী	ভবিষ্যত
কুদ্দুসের	কুদ্দুস
গুরুত্বপুর্ন	গুরুত্ব
খাওয়ানোর	খাওয়া
পদ্ধতিও	পদ্ধতি
উকবা	উকবা
চত্বরে	চত্বর
অভ্যন্তরভাগে	অভ্যন্তর
হিসাবে	হিসাব
ব্রিকস	ব্রিক
অথচ	অথচ
চেতনাকে	চেতনা
সবসময়ই	সবসময়
মেয়েটাও	মেয়ে
কর্মদিবস	কর্মদিবস
অটোরিকশাচালকের	অটোরিকশাচালক
কানুনের	কানুন
ভাগ্যকে	ভাগ্য
অনেকে	অনেক
ঈশ্বরদীর	ঈশ্বরদী
সিয়াটল	সিয়াটল
বিচিত্র	চিত্র
মুনাফিক	মুনাফিক
অনতিদূরে	অনতিদূর
ওমেগা	ওমেগা
বাড়লেও	বাড়ল
ধ্যানের	ধ্যান
থানচি	থানচি
আর্গ	আর্গ
শক্তি	শক্তি
ঠিকঠাক	ঠিক
বিএবি	বিএবি
জীবনরহস্য	জীবন
বিনিয়োগকারী	বিনিয়োগ
ডিএডি	ডিএডি
ট্রেলার	ট্রেলার
প্রদাহ	প্রদাহ
ফাল্গুন	ফাল্গুন
সঙ্গীতজ্ঞ	সঙ্গীত
খৃষ্টাব্দ	খৃষ্ট
যাকথা	যাকথা
গ্যালভানাইজড	গ্যালভানাইজ
উল্টে	উল্ট
প্রস্তাবের	প্রস্তাব
হাফিজকে	হাফিজ
অন্তঃসত্ত্বা	সত্ত্বা
নিম্নে	নিম্ন
দেখাই	দেখ
আলেমরা	আলেম
ধারনাই	ধারনা
আত্মবিশ্বাসী	আত্মবিশ্বাস
শোন	শোন
কানাই	কানাই
কিন্ডারগার্টেনের	কিন্ডারগার্টেন
ননজিরো	জিরো
চিংড়িঘের	চিংড়িঘ
পথগুলো	পথ
চেইনটা	চেইন
মাঝামাঝিতে	মাঝামাঝি
ডিশে	ডিশ
গতবার	গতবার
যুদ্ধটি	যুদ্ধ
সদ্ভাব	সদ্ভাব
রফিকুলের	রফিকুল
নেভাতে	নেভা
ন্যায়	ন্যায়
দমনকারী	দমন
সন্ত্রাসবাদীদের	সন্ত্রাস
গান্ধীবাদী	গান্ধী
অমাবস্যা	অমাবস্যা
মুক্তিযুদ্ধকে	মুক্তিযুদ্ধ
আলস্য	আলস্য
আগ্নেয়	আগ্নেয়
সুনসান	সুনসান
খোদাভীরুদের	খোদা
স্রষ্টা	স্রষ্টা
রচনাবলি	রচনা
তত্ত্বাবধায়নে	তত্ত্বাবধায়ন
আনিসুর	আনিস
এফবিসিসিআইয়ের	এফবিসিসিআই
আব্দুল	আব্দুল
ক্রান্তীয়	ক্রান্ত
লরি	লরি
হয়েছিলো	হয়
বাংলাভাষার	বাংলা
বলবিজ্ঞান	বিজ্ঞান
খালপাড়	খাল
খামারিদের	খামার
অজুহাতে	অজুহাত
ফার্মওয়্যার	ফার্মওয়্যার
নাবিককে	নাবিক
হেসেই	হেসে
স্টেরিও	স্টেরিও
ইনা	ইনা
কচু	কচু
মজে	মজে
লেটার	লেটার
সহপাঠীরা	সহপাঠী
বৈশাখে	বৈশাখ
আগতদের	আগত
বসেছিলাম	বস
দুর্নীতিগ্রস্ত	দুর্নীতি
মারাত্মকভাবে	মারাত্মক
জেব্রার	জেব্রা
হিসাবেও	হিসাব
কম্পিউটারের	কম্পিউটার
সমর্থনকারীরা	সমর্থন
হাইপার	হাইপার
কামরাঙ্গীরচরে	কামরাঙ্গীরচর
এইখানেই	এইখানে
যৌনতায়	যৌন
সংস্করণকে	সংস্করণ
ক্লিয়ারিং	ক্লিয়ার
ফিলাডেলফিয়া	ফিলাডেলফিয়া
ফ্রাঙ্কফুর্টের	ফ্রাঙ্কফুর্ট
সরবরাহও	সরবরাহ
নীলের	নীল
লুঝনিকি	লুঝনি
পরিপূর্ণ	পূর্ণ
পুনর্বাসনে	পুনর্বাসন
পরিশুদ্ধ	শুদ্ধ
অর্থবছর	বছর
এওয়ার্ড	এওয়ার্ড
কনভেনশন	কনভেনশন
সারির	সারি
প্রাণীদেহে	প্রাণী
সময়কার	সময়
পরীক্ষার্থী	পরীক্ষা
ভাগ্যে	ভাগ্য
ঠাকুর	ঠাকুর
প্রেরণকারী	প্রেরণ
জাপা	জাপা
চাইছেন	চাই
ভর্তুকি	ভর্তুকি
বিহ্বল	বিহ্বল
আফ্রিকানরা	আফ্রিকা
কেন্দ্রশাসিত	কেন্দ্রশাসিত
হাঁটা	হাঁট
টাইটানিক	টাইটানিক
জোট	জোট
প্রতিজ্ঞ	প্রতিজ্ঞ
বানিয়াচং	বানিয়াচং
মার্টিনকে	মার্টিন
বাফেলো	বাফেলো
এশিয়াতে	এশিয়া
পাল্টিয়ে	পাল্টি
চাপার	চাপা
কনজিউমার	কনজিউমার
কৃষির	কৃষি
অপরপক্ষে	পক্ষ
হোমিও	হোমিও
কিনেছেন	কিন
এনডিএ	এনডিএ
গ্রহণকে	গ্রহণ
মাইক্রোপ্রসেসর	মাইক্রোপ্রসেসর
হৃদয়বিদারক	হৃদয়বিদারক
শেখাবেন	শেখা
পুলে	পুল
অভয়ারণ্য	অভয়ারণ্য
যাবত	যাবত
সময়সূচী	সময়
সংগঠকেরা	সংগঠক
অনুবন্ধী	অনু
তাপশক্তি	শক্তি
সুমির	সুমি
দায়ীত্ব	দায়ীত্ব
মনোভাবকে	মনোভাব
প্রেমমূলক	প্রেম
নিস্তরঙ্গ	নিস্তরঙ্গ
মুখার্জী	মুখার্জী
গ্রিফিন্ডর	গ্রিফিন্ডর
জানবেন	জানব
ওয়ান্স	ওয়ান্স
ধস্তাধস্তি	ধস্তাধস্তি
গ্রন্থাবলি	গ্রন্থাবলি
প্রবণতার	প্রবণতা
বেহুলা	বেহুলা
চাইবো	চাইবো
গুণগ	গুণ
বেশুমার	বেশুমা
রাখিস	রাখ
কাশফুলের	কাশফুল
জাফরি	জাফরি
উঁচুতে	উঁচু
ইসমাত	ইসমাত
হিজল	হিজল
তালিকাও	তালিকা
বান্ধব	বান্ধব
মাংসপেশি	মাংসপেশি
পেইন্টস	পেইন্ট
টারও	টার
ইভানের	ইভান
প্রোটিনের	প্রোটিন
সদস্যদের	সদ
ফোকর	ফোকর
হুকুমের	হুকুম
হাঙ্গেরি	হাঙ্গেরি
দৌলত	দৌলত
স্থিত	স্থিত
উইলিয়ান	উইলিয়ান
ইংরেজিতে	ইংরেজি
পাহাড়িয়া	পাহাড়
পন্য	পন্য
উক্তিটি	উক্তি
অমিতাভের	অমিতাভ
মতিঝিল	মতিঝিল
শামীমার	শামীমা
ফেলিয়া	ফেল
ইনভেস্টিগেটিভ	ইনভেস্টিগেট
স্কুলশিক্ষক	শিক্ষক
পৌঁছেন	পৌঁছ
শপথের	শপথ
ফিনল্যান্ড	ফিন
পতেঙ্গার	পতেঙ্গা
হয়ছিল	হয়
অধ্যায়টি	অধ্যায়
মাস্টার্ড	মাস্টার্ড
মহাবলীয়ান	মহাবলী
দেশদ্রোহী	দেশ
ছিলো	ছিল
স্মোকি	স্মোকি
বিআইডব্লিউটিসির	বিআইডব্লিউটিসি
অবিস্মরণীয়	স্মরণ
আক্কেলপুরে	আক্কেলপুর
প্রথম	প্রথম
নেপালী	নেপালী
কক্ষগুলি	কক্ষ
অক্ষে	অক্ষ
অর্থাত্	অর্থ
শোনাতে	শোন
খানদের	খান
পাথরঘাটা	পাথরঘাটা
অপমানকর	অপমান
ইনি	ইনি
ফ্যাট	ফ্যাট
পাইথন	পাইথন
ফিডার	ফিড
হেফাযত	হেফাযত
মাঠটির	মাঠ
বাংলাদেশকেই	বাংলাদেশ
করালেও	করা
সিঅ্যান্ডএফ	সিঅ্যান্ডএফ
ভাইয়ের	ভাই
পোষ	পোষ
লোনের	লোন
সূতা	সূতা
পরিবহন	বহন
মনোযোগী	মনোযোগ
বিক্ষোভকারীর	বিক্ষোভ
কালভার্টটি	কালভার্ট
পাঁচটায়	পাঁচ
মেনি	মেন
মাশরাফিরা	মাশরাফি
তুর্কমেনিস্তানে	তুর্কমেনিস্তান
উৎপীড়নের	উৎপীড়ন
লিয়ন	লিয়ন
মৌচাকের	মৌচাক
সাবেলা	সাবেলা
গান্ধীজির	গান্ধী
সেনা	সেনা
খন্দকার	খন্দকার
ক্ষমতায়নে	ক্ষমতা
তিনবার	তিন
গবেষনায়	গবেষনা
বাংলাদেশিরাও	বাংলা
ওঠানোর	ওঠ
হলিউডি	হলিউড
বার্তাদ্বারা	বার্তা
রিভিউ	রিভিউ
ঈমানদারগণ	ঈমান
আসনসংখ্যা	আসন
লিলি	লিলি
তিব্বতীয়	তিব্বত
কারাদণ্ডে	কারাদণ্ড
এমপিও	এমপিও
হীরা	হীরা
সোহরাব	সোহরাব
পুলিসের	পুলিস
মুদ্রাস্ফীতির	মুদ্রাস্ফীতি
ভেদাভেদের	ভেদাভেদ
শেষেই	শেষ
সম্মানবোধ	সম্মান
মারপিট	মারপিট
আত্মমগ্ন	আত্ম
কিংডম	কিংডম
বালিয়াড়ি	বালিয়াড়ি
কোলে	কোল
রক্ষণশীলতার	রক্ষণশীল
সহিংসতার	সহিংস
শুল্কায়ন	শুল্ক
তথ্যানুসন্ধান	তথ্যানুসন্ধান
অক্ষ	অক্ষ
সরকারই	সরকারই
পানিবাহিত	পানি
আলজেরিয়ার	আলজেরিয়া
আতঙ্কের	আতঙ্ক
প্রয়োজনগুলো	প্রয়োজন
ব্যবস্থায়	ব্যবস্থা
মেসবাহ	মেসবাহ
শুনানিকালে	শুনানি
অদক্ষতার	অদক্ষ
রাতারগুল	রাতারগুল
বিশ্বকাপজয়ী	বিশ্বকাপজয়
খালুর	খালু
ঘাতকের	ঘাতক
গুয়াংডং	গুয়াংডং
পদায়ন	পদায়ন
ব্যাম্স	ব্যাম্স
তত্ত্বও	তত্ত্ব
রাক্ষস	রাক্ষস
জেনেছি	জেনে
আয়োজকরা	আয়োজক
মানসুর	মানসুর
পরে	পর
চুনতি	চুনতি
মাড়	মাড়
কুষ্ঠ	কুষ্ঠ
বিবিআইএন	বিবিআইএন
ভিডিওসহ	ভিডিও
সন্তানসহ	সন্তান
অপরজন	জন
আগত	গত
স্থানীয়করণ	স্থান
বিভাগকে	বিভাগ
ছামূদের	ছামূদ
হাতও	হাত
সমস্যাপূর্ণ	সমস্যা
কোকিল	কোকিল
আরিফুজ্জামান	আরিফুজ্জামান
মারাত্বক	মারাত্বক
সাইকোলজিক্যাল	সাইকোলজিক্যাল
তেরটি	তের
তোমাদিগকে	তোমাদিগকে
এঁকেছে	এঁকে
ক্যান্টনমেন্ট	ক্যান্টনমেন্ট
গোঁজা	গোঁজা
রয়াল	রয়াল
নিম্নকক্ষের	নিম্নকক্ষ
ভোটব্যাংক	ভোট
উচ্ছল	উচ্ছল
মিশনারিদের	মিশনারি
উপকারই	উপকার
অন্তর্ঘাত	অন্তর্ঘাত
বিশ্লেষণে	বিশ্লেষণ
লাগানো	লাগা
ক্যাডাররা	ক্যাডার
সনাতন	সনাতন
মার্কেসের	মার্কেস
ঘোমটা	ঘোমটা
বালিশের	বালিশ
বিরতি	বিরত
চিত্রায়িত	চিত্র
দাম্পত্য	দাম্পত্য
পাঠিয়েছেন	পাঠিয়েছ
সংযোগকারী	সংযোগ
বিনিয়োগের	বিনিয়োগ
হর্ষধ্বনি	হর্ষ
মনমরা	মন
সোচ্চার	সোচ্চার
বৈদ্যের	বৈদ্য
কদমতলা	কদমতলা
সুবাস	সুবাস
আইরিন	আইরিন
টাইব্রেকারে	টাইব্রেকার
জলোচ্ছ্বাস	জলোচ্ছ্বাস
মুক্তোর	মুক্তো
জগদীশপুর	জগদীশপুর
কাশ্যপ	কাশ্যপ
ডব্লিউটিও	ডব্লিউটিও
নয়টায়	নয়
রিচার্ড	রিচার্ড
আত্মসম্মানবোধ	আত্মসম্মান
শাবানা	শাবানা
অকপট	কপট
বিনিময়	বিনিময়
ধর্মান্তরিত	ধর্মান্তর
ফিরল	ফিরল
বেয়াদবি	বেয়াদব
প্রচণ্ড	প্রচণ্ড
লগ্নে	লগ্ন
মুক্তধারা	মুক্ত
প্রিন্টের	প্রিন্ট
দিবসকে	দিবস
যনির	যনি
দৃঢ়সংকল্পবদ্ধ	দৃঢ়সংকল্প
অনিচ্ছায়	নিচ্ছা
ক্যাফেতে	ক্যাফে
ব্যাগিং	ব্যাগ
চিন্তাধারা	চিন্তা
আতলেতিকো	আতলেতিকো
স্বস্তি	স্বস্তি
আংকেল	আংকেল
বড়লোকের	বড়
টাইটানিয়াম	টাইটানিয়াম
বিশেষাধিকার	বিশেষাধিকার
কুদরত	কুদরত
সর্গ	সর্গ
নিম্নোক্ত	নিম্নোক্ত
পুরুস্কার	পুরুস্কার
ব্রড	ব্রড
মোটরসাইকেলযোগে	মোটর
সাইপিয়েনেট	সাইপিয়েনেট
বিয়ারিংগুলি	বিয়ারিং
উল্লেখ্যযোগ্য	উল্লেখ
দুদিকে	দিক
ঠোঁট	ঠোঁট
সমালোচনাও	সমালোচনা
পিঠা	পিঠা
তেলাওয়াত	তেলাওয়াত
স্কুলকে	স্কুল
সম্পূরকসমূহ	সম্পূরক
খননযন্ত্রের	যন্ত্র
গ্রীষ্মমন্ডলীয়	গ্রীষ্মমন্ডলীয়
বিলাসিতা	বিলাসিতা
প্রকাশকরা	প্রকাশক
হুজুগে	হুজুগ
লক্ষের	লক্ষ
ব্যাপ্তির	ব্যাপ্তি
যাত্রাপালার	যাত্রাপালা
ঢেউটিন	টিন
বনসাই	সাই
পরাগের	পরাগ
শোধন	শোধন
নলকূপের	নলকূপ
হিমোগ্লোবিনের	হিমোগ্লোবিন
হুইসেল	হুইসেল
কিবোর্ডের	কিবোর্ড
বিএসটি	বিএসটি
মতান্তর	মত
বুধের	বুধ
ব্র্যান্ডগুলো	ব্র্যান্ড
সম্ভবপর	সম্ভব
উপস্বাস্থ্য	স্বাস্থ্য
ঘরবাড়ি	ঘরবাড়ি
অনশন	অনশন
কাস্ত্রো	কাস্ত্রো
আইনজীবীরা	আইন
রবীন্দ্রনাথের	রবীন্দ্রনাথ
জবানিতে	জবানি
শাখারভ	শাখা
ডানের	ডান
শ্রেণির	শ্রেণ
বাগডোগরা	বাগডোগরা
প্রাইজবন্ড	প্রাইজ
ক্রিপ্টোকারেন্সির	ক্রিপ্টোকারেন্সি
জাগিয়েছিল	জাগিয়ে
টেররিস্ট	টেরর
শীর্ষেন্দু	শীর্ষেন্দু
উঠতাম	উঠ
সানশাইন	সানশাইন
ভূঁইয়াদের	ভূঁইয়া
সিবিই	সিবিই
সাঁওতালদের	সাঁওতাল
মোমেন্ট	মোমেন্ট
সোমের	সোম
আমাজান	আমাজান
প্যাটিনসন	প্যাটিনসন
এনএক্স	এনএক্স
ক্লিনটনের	ক্লিনটন
ভালোবাসেন	ভালো
তথ্যসমূহ	তথ্য
লোকদলের	লোক
ওপেক	ওপেক
লড়া	লড়া
মাঝখান	মাঝখান
তেরোটি	তেরো
দাতাদের	দাতা
পিতরের	পিতর
মজুদ	মজুদ
ক্ষতিগ্রস্থ	ক্ষতি
শূন্যপদে	শূন্যপদ
প্রকল্পের	কল্প
নয়টা	নয়
পরদিন	পর
অর্থটা	অর্থ
লোকাল	লোকাল
মলদ্বারে	মল
পদত্যাগপত্র	পদত্যাগ
বছরটা	বছর
বিক্রয়কর্মী	বিক্রয়
পদস	পদ
শীষে	শীষ
মহাসড়কের	সড়ক
ফটকে	ফটক
স্কিন	স্কিন
অল্পবয়স্করা	অল্পবয়স্ক
হার্ভার্ডে	হার্ভার্ড
কোবরিনের	কোবরিন
ভারসাম্যের	ভারসাম্য
কাব্যগ্রন্থের	গ্রন্থ
আদিবাসীদের	আদি
নিকো	নিকো
মোছলেম	মোছলেম
এক্সপোতে	এক্সপো
ভাসিয়েছেন	ভাসিয়ে
উনিশশো	উনিশ
আর্তি	আর্তি
চ্যুতি	চ্যুত
বিদ্রোহীর	বিদ্রোহী
প্রজেক্টটি	প্রজেক্ট
ব্র্যাডলি	ব্র্যাডলি
শতকোটি	কোটি
রায়চৌধুরী	রায়চৌধুরী
রাজ্যেও	রাজ্য
আকাশটা	আকাশ
কিস্তির	কিস্তি
অনুশীলনে	অনুশীলন
আশুগঞ্জের	আশুগঞ্জ
বাডেন	বাডেন
কালকের	কাল
স্টানার	স্টান
প্রজননকাল	প্রজনন
নাগরদোলা	নাগরদোলা
গতবছর	বছর
মানুষদের	মানুষ
অনুগতদের	অনুগত
ভেক্টরের	ভেক্টর
যৌথবাহিনীর	যৌথ
শুমাখার	শুমাখার
রোগাক্রান্ত	রোগ
হইলে	হইল
লামিয়া	লামিয়া
গাই	গাই
দুর্দশা	দশা
চালকদের	চালক
বানসালির	বানসাল
মুসলিমবিরোধী	মুসলিম
মণিপুর	মণিপুর
চায়নিজ	চায়নিজ
হরফে	হরফ
ছিন্নমূল	মূল
রকমফের	রকম
বাকা	বাকা
কার্ডটি	কার্ড
মুজিব	মুজিব
রুনু	রুনু
কাটানো	কাটানো
ভাবমূর্তির	ভাব
বুরহান	বুরহান
মিউনিখ	মিউনিখ
ওয়াটসন	ওয়াটসন
ট্যাবু	ট্যাবু
ছায়াপথ	ছায়া
মরিচা	মরিচা
মাঝপথেই	মাঝ
শিবাজীর	শিবাজী
সরাইলের	সরাইল
পুনর্গঠন	পুনর্গঠন
খতিয়ান	খতিয়ান
অ্যাকশনের	অ্যাকশন
তৃণমূলে	তৃণমূল
জিলাপি	জিলাপি
গরিব	গরিব
প্রশ্নটা	প্রশ্ন
কোত্থেকে	কোত্থেকে
মাহফুজ	মাহফুজ
দুর্দান্তভাবে	দুর্দান্ত
ফ্রাঙ্কোর	ফ্রাঙ্কো
সাজেক	সাজেক
দলগুলোতে	দলগুলো
শিল্পায়িত	শিল্প
ধৈর্যশীলতা	ধৈর্য
শিক্ষাগুলোকে	শিক্ষা
ড্রেনের	ড্রেন
গার্ডনার	গার্ডনার
উভয়পক্ষের	উভয়পক্ষ
মেরেছিল	মেরে
হটেস্ট	হটেস্ট
অঙ্গপ্রত্যঙ্গ	অঙ্গপ্রত্যঙ্গ
মহাস্থবির	স্থবির
পুনরূদ্ধার	পুনরূদ্ধার
চোরাবালি	চোর
জ্ঞান	জ্ঞান
কন্ডিশন	কন্ডিশন
আড়মোড়া	আড়মোড়া
কম্পাইল	কম্পাইল
ভেলোর	ভেলো
প্রোগ্রামকে	প্রোগ্রাম
সময়কালকে	সময়
যাবেই	যাব
স্রেফ	স্রেফ
মানবিকতার	মানবিকতা
মালিককে	মালিক
শোয়েব	শোয়েব
উড়িষ্যায়	উড়িষ্যা
অ্যাকিলিসের	অ্যাকিলিস
ওয়াইফ	ওয়াইফ
তেতে	তেত
মার্কো	মার্কো
নলের	নল
নিকেশের	নিকেশ
হইও	হই
হিজবুল্লাহর	হিজবুল্লাহ
জলদস্যুতা	জলদস্যু
ছেলেটাকে	ছেলে
টাই	টাই
অতিমাত্রায়	অতিমাত্রা
শ্রবণে	শ্রবণ
জাহাজগুলোর	জাহাজ
সিরাজগঞ্জের	সিরাজগঞ্জ
বাস্তবসম্মত	বাস্তবসম্মত
আশার	আশা
পোষকের	পোষক
হিউজ	হিউজ
নিয়ম	নিয়ম
ডিরেক্ট	ডিরেক্ট
দেলোয়ারা	দেলোয়ারা
কাতালানদের	কাতালান
এড়াতেই	এড়াতে
ঘুমে	ঘুম
দুলিয়ে	দুল
বিশ্লেষণমূলক	বিশ্লেষণ
জসীমউদ্দীন	জসীমউদ্দীন
ইএসপিএন	ইএসপিএন
প্রমাণে	প্রমাণ
কোষীয়	কোষ
কুয়াংচৌ	কুয়া
লিসার	লিসা
ত্বকে	ত্বক
তথ্যপূর্ণ	তথ্য
শিশুকন্যা	কন্যা
সমীপে	সমীপ
নামটি	নাম
উর্বরতার	উর্বর
লিয়াকত	লিয়াকত
স্বয়ংক্রিয়ভাবে	স্বয়ংক্রিয়
খুশি	খুশি
দায়িত্বই	দায়িত্ব
আগেও	আগে
ওয়েস্টমিনস্টার	ওয়েস্টমিনস্টার
এনপিপি	এনপিপি
সিঁধেল	সিঁধেল
ইমারত	ইমারত
ভীতিপ্রদ	ভীতি
ল্যান্ডার	ল্যান্ড
ওজিল	ওজিল
ঢাকাইয়া	ঢাকা
ডুপ্লেক্স	ডুপ্লেক্স
রিভিশন	রিভিশন
নববধূ	বধূ
মামুনের	মামুন
লেজের	লেজ
পুনর্বিন্যস্ত	পুনর্বিন্যস্ত
আগেরবার	আগে
জনপদ	জনপদ
কর্মযজ্ঞের	কর্মযজ্ঞ
অধ্যায়	অধ্যায়
অলিম্পিকস	অলিম্পিক
রানই	রান
অস্ট্রেলিয়	অস্ট্রেলিয়
হিসার	হিসার
জোনে	জোনে
হোসেনও	হোসেন
ধ্যানে	ধ্যান
পুষ্প	পুষ্প
ঠদের	দের
ধার্য	ধার্য
হ্যাগ্রিড	হ্যাগ্রিড
মাফিয়াদের	মাফিয়া
স্তরসমষ্টি	স্তর
নওশাবা	নওশাবা
সিসার	সিসা
এসপ্ল্যানেড	এসপ্ল্যানেড
লাঠিয়াল	লাঠি
প্ল্যাকার্ডে	প্ল্যাকার্ড
বিক	বিক
জিলা	জিলা
টানাপোড়েনের	টানাপোড়েন
রামায়ণের	রামায়ণ
পৃথকীকরণের	পৃথক
কালীগঙ্গা	কালীগঙ্গা
ঘনঘন	ঘন
রাজপরিবারে	রাজপরিবার
মানবী	মানব
সুযোগে	সুযোগ
পেনশন	পেনশন
মায়ের	মা
বায়ুতে	বায়ু
অপরদিকে	অপরদিক
গিয়ার্স	গিয়ার
গাছটার	গাছ
বেনামি	নাম
তিনটিতেই	তিন
ভাষাভাষীদের	ভাষাভাষী
কানু	কানু
গলিয়ে	গলিয়
কৌশলটা	কৌশল
টেস্টেই	টেস্ট
স্টেরয়েড	স্টেরয়েড
হাইড্রোজেন	হাইড্রোজেন
খরচায়	খরচ
সরকারে	সরকার
মাছে	মাছ
মনোভাবের	মনোভাব
টেকনোলজিস্ট	টেকনোলজি
শোষণের	শোষণ
হাউসের	হাউস
ছানাবড়া	ছানা
স্থাপত্যশিল্পের	স্থাপত্যশিল্প
অরুণ	অরুণ
প্রতিমার	প্রতিমা
নিরাপদেই	নিরাপদ
করতাল	করতাল
ব্যক্তিগত	ব্যক্ত
ফেলেনি	ফেল
ডুয়াল	ডুয়াল
অর্ধাংশ	অর্ধ
উচ্চমূল্য	উচ্চ
বুদ্ধপূর্ণিমা	বুদ্ধ
বলোনি	বল
নূন্যতম	নূন্য
কুণ্ঠিত	কুণ্ঠ
হিলারির	হিলারি
মেডিক্যাল	মেডিক্যাল
নোটারি	নোটারি
বলেছেঃ	বল
প্যাকেজগুলির	প্যাকেজ
ক্যাফে	ক্যাফে
জাতীয়ভাবে	জাতীয়
পরামর্শদাতার	পরামর্শ
মুদ্রাজুড়ি	মুদ্রাজুড়ি
বিয়ে	বিয়ে
প্রেসিডেন্টের	প্রেসিডেন্ট
উড়ালসেতু	সেতু
মানুষখেকো	মানুষ
রোজের	রোজ
শান্তিনগর	শান্তিনগর
অধ্যক্ষসহ	অধ্যক্ষ
অনুসন্ধানমূলক	অনুসন্ধান
ধরনা	ধরন
পরিমাপের	পরিমাপ
কমিক্সের	কমিক্স
অনাপত্তিপত্র	অনাপত্তি
পোপ	পোপ
পৌরাণিক	পৌরাণ
সিলভিয়া	সিলভিয়া
দেখোনি	দেখ
অন্যটা	অন্য
বোর্ডটি	বোর্ড
সরকারী	সরকার
বালতিস্তান	বালতিস্তান
সুপারহিট	সুপারহিট
ব্রিকসের	ব্রিকস
টালবাহানা	বাহানা
অনির্দিষ্টকাল	অনির্দিষ্টকাল
রিমেক	রিমেক
উপশাখা	শাখা
বর্তমানের	বর্তমান
বমি	বমি
মধ্যস্বত্বভোগীদের	মধ্য
ক্রমেই	ক্রম
পক্ষপাতিত্বের	পক্ষপাতিত্ব
অস্ট্রিয়া	অস্ট্রিয়া
মনিরের	মনির
প্যাকেটজাত	প্যাকেট
গভীরতা	গভীর
জঙ্গির	জঙ্গি
কলেজছাত্রীকে	ছাত্রী
ছয়ের	ছয়
এতদিন	দিন
রফিক	রফিক
ক্যাস্ট্রো	ক্যাস্ট্রো
মাজনুন	মাজনুন
ত্রিকোণমিতিক	ত্রিকোণমিতি
মার্চের	মার্চ
অগ্রসরমান	অগ্রসর
টিএন	টিএন
এমিরেটস	এমিরেটস
ননদের	ননদ
সুরমার	সুরমা
অন্তর্ভুক্তি	অন্তর্ভুক্ত
অর্ণব	অর্ণব
ক্ষণজন্মা	ক্ষণ
ডালা	ডালা
পাড়া	পাড়া
উইলের	উইল
ইসলামপুর	ইসলামপুর
এএফএল	এএফএল
ইসাহাক	ইসাহাক
গলাধঃকরণ	গলা
পরাজিত	পরা
উপযুক্ততা	উপযুক্ত
গোলটেবিলে	গোলটেবিল
বটি	টি
নাহিদের	নাহিদ
এগুলোতে	এগুলো
লাফাতে	লাফ
জেলেকে	জেলে
প্রশিক্ষণার্থী	প্রশিক্ষণ
বদলি	বদল
গুজরাট	গুজরাট
সুখভোগ	সুখভোগ
খুনি	খুন
শামছুন্নাহার	শামছুন্নাহার
মাদ্রিদের	মাদ্রিদ
পুত্ত্র	পুত্ত্র
দেখুনঃ	দেখ
জাদুমন্ত্র	জাদু
ফেসিয়াল	ফেস
আখ্যায়িত	আখ্যায়িত
আসায়	আসা
অন্তরাত্মা	অন্তরাত্মা
ফেরারী	ফেরারী
নাগাল্যান্ড	নাগাল্যান্ড
চলাফেরার	চলা
মুক্তচিন্তার	চিন্তা
রনো	রনো
ইসলামি	ইসলাম
জন্মদাতা	জন্ম
ইউনিস	ইউনিস
গ্যাসকেট	গ্যাসকেট
জলস্রোত	জল
ম্যানচেস্টার	ম্যানচেস্টার
এলবিডব্লু	এলবিডব্লু
কলমে	কলম
আশরাফ	আশরাফ
শরীরচর্চা	শরীরচর্চা
উত্সাহ	উত্সাহ
শিল্পে	শিল্প
ইয়েলো	ইয়েলো
তড়িৎচৌম্বকত্ব	তড়িৎচৌম্বক
সমমান	সমমান
গুণকে	গুণ
কর্মকারের	কর্ম
মুঘলরা	মুঘল
মাউন্টব্যাটেন	মাউন্টব্যাটেন
অ্যাম্বুলেন্সে	অ্যাম্বুলেন্স
দম্ভ	দম্ভ
মনোরম	মনোরম
জোলি	জোলি
তারপরে	তারপর
হরদম	হরদম
প্রান্তগুলি	প্রান্ত
হালকা	হাল
নিয়ামত	নিয়ামত
ব্রিফকেস	ব্রিফকে
সিম্পোজিয়াম	সিম্পোজিয়াম
তুষ	তুষ
ফাইয়াজ	ফাইয়াজ
মিথ্যা	মিথ্যা
নৃত্যশিল্পী	নৃত্যশিল্পী
প্রশিক্ষনের	শিক্ষন
ফাতিহা	ফাতিহা
বিদ্যুত	বিদ্যুত
নির্দিষ্ট	নির্দিষ্ট
হেসেছে	হেসেছ
জীবাণুর	জীবাণু
হোসাইনের	হোসাইন
সেপ্টে	সেপ্ট
শিক্ষাগুরু	শিক্ষা
নর্দের	নর
পয়সা	পয়সা
নারাইনের	নারাইন
বিশ্বস্ততার	বিশ্বস্ত
কোয়াড	কোয়াড
পৌঁছেছিলাম	পৌঁছেছি
মেন্ডেট	মেন্ডেট
রাখিবার	রাখ
শিখবেন	শিখবে
নোবেলজয়ী	নোবেল
সাবস্টেশন	স্টেশন
দুপুরের	দুপুর
ক্যাচের	ক্যাচ
ইয়ার্ডে	ইয়ার্ড
শতবর্ষের	শত
মেসেজটা	মেসেজ
সাহেবকে	সাহেব
লেখানোর	লেখা
ইয়েন	ইয়েন
দৌড়াচ্ছে	দৌড়াচ্ছে
রিসেট	সেট
আনন্দজনক	আনন্দ
জুডো	জুডো
স্থানে	স্থান
আবদীন	আবদীন
দুদলের	দুদল
ব্যাংকসহ	ব্যাংক
শিল্পাঞ্চলের	শিল্প
মহাদেশের	দেশ
রমশালী	রমশ
একনেকে	একনেক
হিরোইন	হিরোইন
আসর	আসর
সিন্থেটিক	সিন্থেটিক
পুরোপুরি	পুরোপুরি
অ্যানিস্টন	অ্যানিস্টন
কথাটিই	কথা
বোস্তামী	বোস্তামী
হাসছে	হাস
ববির	ববি
অর্লিন্স	অর্লিন্স
সমন্বয়	সম
ঠিকাদারি	ঠিকাদার
হাসিব	হাসিব
স্ত্রীও	স্ত্রী
বেনফিকা	বেনফিকা
স্লোভাকিয়াকে	স্লোভাকিয়া
কোয়ার্টজ	কোয়ার্টজ
দূতকে	দূত
আইসক্রীম	আইস
শব্দাবলী	শব্দ
ইউসেবিও	ইউসেবি
সিসিল	সিসিল
টেকনো	টেকনো
টেলিফোনে	টেলিফোন
আলফ্রেদো	আলফ্রেদো
রাখলেন	রাখ
রদিয়াল্লহু	রদিয়াল্লহু
কুলসুম	কুলসুম
সুবিধাদি	সুবিধা
আরো	আরো
ডাচদের	ডাচ
ঢিলেমি	ঢিলে
সঙ্গের	সঙ্গ
চেয়ারম্যানসহ	চেয়ারম্যান
মানতে	মান
বেনিন	বেনিন
থাকবেনা	থাক
সমভূমিতে	সমভূমি
অ্যালবামে	অ্যালবাম
সন্ত্রাসবাদে	সন্ত্রাস
পরিষদ	ষদ
হাইড্রোলিক	হাইড্রোলিক
আঁধারে	আঁধার
রুমার	রুমা
কামোদ্দীপক	কামোদ্দীপক
মূল্যবোধে	মূল্য
শিশুপার্কের	শিশু
কাঠগড়ায়	কাঠগড়া
গানটা	গান
পিআইবির	পিআইবি
তহবিলে	তহবিল
ভেবেছি	ভেবে
ভূত্বকীয়	ভূত্বক
খুলনায়	খুলনা
ডিসপেনার	ডিসপেন
দ্বিখণ্ডিত	খণ্ডিত
হুলুস্থুল	হুলুস্থুল
চিকিৎসাবিজ্ঞানে	চিকিৎসা
ইমরুলকে	ইমরুল
শফিকুলকে	শফিকুল
দূষণমুক্ত	দূষণ
হিউয়েন	হিউয়েন
আধ্যাত্মিকতা	আধ্যাত্মিক
প্রত্যাশাকে	প্রত্যাশা
গানসহ	গান
তন্নতন্ন	তন্নতন্ন
বাড়িতে	বাড়
রাজাপক্ষে	রাজা
প্রতাপাদিত্য	প্রতাপাদিত্য
ভালবাসাই	ভালবাসা
আত্মবিশ্বাস	আত্মবিশ্বাস
বিচারমন্ত্রী	বিচার
ধুলা	ধুলা
চিতার	চিতা
আইনপ্রণেতারা	আইন
নার্সারি	নার্সারি
জিজ্ঞাসু	জিজ্ঞাস
অটোরিকশাসহ	অটো
নোংরামি	নোংরা
উপন্যাসটিতে	উপন্যাস
বিকাশে	বিকাশ
সরলতা	সরল
মাহজাবীন	মাহজাবীন
আমল	আমল
কুর্তা	কুর্তা
ওয়াটস	ওয়াট
হাফিজউদ্দিন	হাফিজউদ্দিন
বিবর্ধিত	বর্ধিত
ছত্রে	ছত্র
অনাবাসিক	বাস
যুদ্ধকালীন	যুদ্ধ
হাইওয়ে	হাইওয়ে
পেডিয়াট্রিক	পেডিয়াট্রিক
সোলাইমান	সোলাইমান
স্বভাবজাত	স্বভাব
পিয়ংইয়ং	পিয়ংইয়ং
মিরাট	মিরা
পৃষ্ঠায়	পৃষ্ঠা
সুবাহ	সুবাহ
নকশাকারী	নকশা
চোখের	চোখ
আড়তের	আড়ত
ফটোগ্রাফি	ফটোগ্রাফ
বারডেমের	বারডেম
ওতপ্রোতভাবে	ভাবে
হানাহানির	হানাহানি
সাহসও	সাহস
উইকেটই	উইকেট
বটগাছ	গাছ
পারছি	পার
হীট	হীট
নামাজে	নামাজ
মুভমেন্টের	মুভমেন্ট
হরে	হর
বাবামারা	বাবামা
সিরাজউদ্দৌলা	সিরাজ
খুশীর	খুশী
কনসার্টে	কনসার্ট
র্যাম	র্যাম
অভিশপ্ত	অভিশপ্ত
আসলামের	আসলাম
এলাকাটির	এলাকা
আশুগঞ্জ	আশুগঞ্জ
ফেলেছি	ফেল
দীপঙ্কর	দীপঙ্কর
জানাচ্ছি	জানা
ঘরই	ঘর
জটিলতা	জটিল
অনার্য	অনার্য
চিড়িয়াখানার	চিড়িয়াখানা
অফিসকক্ষে	অফিসকক্ষ
ভ্রূণের	ভ্রূণ
দক্ষিণদিকে	দক্ষিণ
হায়েয	হায়েয
মাল্টিপল	মাল্টিপল
দেবোত্তর	দেবোত্তর
সম্রাট	সম্রাট
জামালকে	জামাল
জমিন	জমিন
সেইসময়	সময়
কীভাবেই	কীভাবে
বিদ্যুৎকেন্দ্রে	বিদ্যুৎকেন্দ্র
ডেভিল	ডেভিল
অনুষদভুক্ত	অনুষদ
শুনি	শুন
রিলিজ	রিলিজ
বিষয়টার	বিষয়
দুঃখের	দুঃখ
মনোমুগ্ধকর	মুগ্ধ
অভিষিক্ত	অভিষিক্ত
বার্থডে	বার্থ
মনোহরপুর	মনোহরপুর
বঙ্গবন্ধুসহ	বঙ্গ
পরিকল্পনাগুলি	কল্পনা
দুঃখজনক	দুঃখ
যোষেফ	যোষেফ
গ্রন্থাকারে	গ্রন্থ
চেয়েছিলাম	চেয়ে
রাওয়ালপিন্ডিতে	রাওয়ালপিন্ডি
ভাবনাই	ভাবনা
মক্তবে	মক্তব
পাখিদের	পাখি
বিব্রতকর	বিব্রত
গরুড়	গরু
প্রক্রিয়াজাতকরণের	প্রক্রিয়া
অনুরূপ	রূপ
নিজেদেরকেই	নিজেদের
পৌছিয়েছি	পৌছ
মৃদুমন্দ	মৃদু
অ্যাসোসিয়েশনের	অ্যাসোসিয়েশন
জলার	জলা
সদরপুর	সদরপুর
শুভাকাঙ্ক্ষী	শুভাকাঙ্ক্ষী
আর্সেন	আর্সেন
দাবী	দাবী
নামলেন	নামল
বাঁচতে	বাঁচ
অ্যাপ	অ্যাপ
শ্রমিকনেতাদের	শ্রমিকনেতা
কোনোভাবেই	কোনোভাবে
ইয়র্কের	ইয়র্ক
রাষ্ট্রদূতকে	রাষ্ট্র
মেয়েকেও	মেয়ে
মোদ্দা	মোদ্দা
পাহাড়ে	পাহাড়
নির্মমতা	নির্মম
ঘোড়া	ঘোড়া
ভঙ্গুরতা	ভঙ্গুর
মিনিবাস	মিনিবাস
ফ্রেন্ডশিপ	ফ্রেন্ড
সময়েই	সময়
আহসানউল্লাহ	আহসানউল্লাহ
সাতে	সাত
চিকিৎসাবিদ্যা	চিকিৎসা
অযোগ্যতা	যোগ্য
রাজাপুরের	রাজাপুর
সরাইখানা	সরাইখানা
মাণ	মাণ
চারদিন	চারদিন
সুগার	সুগার
নিবন্ধের	নিবন্ধ
মুক্তিযুদ্ধের	মুক্ত
গ্রাইন্ডিংয়ের	গ্রাইন্ডিং
স্ট্রীট	স্ট্রীট
দেবর	দেবর
মিলার	মিলা
পলিসিতে	পলিসি
ইমপ্রেশন	ইমপ্রেশন
জাঁতাকলে	জাঁতাকল
স্বাদযুক্ত	স্বাদ
বিকাশকে	বিকাশ
কথামত	কথা
ঘটনাগুলি	ঘটনা
প্রলুব্ধ	প্রলুব্ধ
বানাই	বানা
ভিভো	ভিভো
বুলেট	বুলেট
তৎপুরুষ	পুরুষ
চন্দ্রগুপ্ত	চন্দ্র
দোসরদের	দোসর
প্লাজার	প্লাজা
সমালোচকদের	সমালোচক
হামলাকে	হামলা
সাক্ষাত্কারে	সাক্ষাত্কার
আজাদকে	আজাদ
যুগ্মভাবে	যুগ্ম
মাসেরও	মাস
মোংলা	মোংলা
বিজয়পুর	বিজয়পুর
বাপ্পীর	বাপ্পী
ভিনাইল	ভিনাইল
বাড়ালে	বাড়াল
প্লাটফর্মে	প্লাটফর্ম
করমুক্ত	করমুক্ত
পণ্যবাহী	পণ্য
বিজয়ে	বিজয়
উপমার	উপমা
অপশনের	অপশন
সুফি	সুফি
হাইম	হাইম
মুক্তবাজার	মুক্তবাজার
ধারাবাহিকতার	ধারাবাহিকতা
ইংরাজী	ইংরাজী
পাটোয়ারী	পাটোয়ারী
মিউজিক্যাল	মিউজিক্যাল
শ্লোগান	শ্লোগান
সাদার	সাদা
কর্মকাণ্ডে	কর্ম
বনবিড়াল	বনবিড়াল
বেতনবৈষম্য	বেতন
খাবারই	খাবার
মনিপুরী	মনিপুরী
আমীর	আমীর
ব্রিসবেনের	ব্রিসবেন
প্রয়াস	প্রয়াস
বখতিয়ারের	বখতিয়ার
পৌছলেন	পৌছল
মহান	মহা
কান্দিরপাড়	কান্দিরপাড়
প্ল্যাটফর্মের	প্ল্যাটফর্ম
কল্যাণপুর	কল্যাণপুর
সমা	সম
গোপনীয়	গোপন
নষ্ট	নষ্ট
কমিশনার	কমিশন
ডিকেন্স	ডিকেন্স
লিপিড	লিপিড
চিরসবুজ	সবুজ
সিরিসেনার	সিরিসেনা
লিবার্টির	লিবার্টি
সময়সীমা	সময়
ভাস্কুলার	ভাস্কুলার
দলটাকে	দল
বিরুলিয়া	বিরুলিয়া
অব্রাহামের	অব্রাহাম
লাগব	লাগব
আবাস	বাস
উচ্চশিক্ষা	শিক্ষা
যুগপত	যুগপত
আজকালকার	আজকাল
মেক্সিকোকে	মেক্সিকো
আবদুল্লাহ্	আবদুল্লাহ
অগ্রযাত্রায়	যাত্রা
মুক্তি	মুক্ত
নদে	নদ
বিধাননগর	বিধাননগর
রিপ্রেজেন্টেশন	রিপ্রেজেন্ট
আবেদনই	আবেদন
ম্যুরাল	ম্যুরাল
গাওয়া	গাওয়া
ফৌজদার	ফৌজদার
বুঝছে	বুঝ
ফেডারেশনের	ফেডারেশন
নদীভাঙনের	নদীভাঙন
ভাবনাকে	ভাবনা
ইয়ান	ইয়ান
রূপটি	রূপ
রেকর্ডগুলো	রেকর্ড
দীপাবলির	দীপাবলি
মেলামেশা	মেলামেশা
বনধ	বন
দেখিলাম	দেখ
উপাধ্যক্ষ	উপাধ্যক্ষ
হোচা	চা
ঢালিউডের	ঢালিউড
নিওলিথিক	নিওলিথিক
পূর্ববর্তী	পূর্ব
হাবিবকে	হাবিব
গলি	গলি
পরীক্ষণকে	পরীক্ষণ
ব্রায়ান	ব্রায়ান
ধ্যানমগ্ন	ধ্যান
ভাইরে	ভাইর
শাস্ত্রপদ	শাস্ত্র
ফাইলিং	ফাইল
ক্লিপটি	ক্লিপ
নির্দেশনার	নির্দেশনা
নমুনাগুলি	নমুনা
চতুর্মাত্রিক	চতুর
সংশ্লিষ্টদের	সংশ্লিষ্ট
পাওয়া	পাওয়া
পোর	পোর
মারণাস্ত্র	মারণাস্ত্র
নীতিগুলোকে	নীতি
খেলোয়াড়ি	খেলোয়াড়
বর্ষপঞ্জির	বর্ষপঞ্জি
দুরন্ত	দুর
ক্লাসমেট	ক্লাস
গ্রন্থমেলার	গ্রন্থ
শৃঙ্খলা	শৃঙ্খল
সক্ষমতা	সক্ষম
ট্রুডোর	ট্রুডো
রুমন	রুমন
বাঁচাও	বাঁচা
বৎসর	বৎসর
দমে	দম
অধিকারবিষয়ক	অধিকার
জ্যাকবের	জ্যাকব
সংমিশ্রিত	মিশ্র
এব্যাপারে	এব্যাপার
থাইরয়েডের	থাইরয়েড
মহাল	মহা
বেরোনো	বের
মাহেন্দ্র	মাহেন্দ্র
যোগযোগ	যোগযোগ
ব্যক্তিরাই	ব্যক্তি
ন্যাড়া	ন্যাড়া
ভাবটা	ভাব
প্রভেদ	প্রভেদ
ঠেকাবে	ঠেকা
জখম	জখম
রকেট	রকেট
মন্ত্রমুগ্ধ	মন্ত্রমুগ্ধ
বাচ্চাগুলোর	বাচ্চা
বিরুদ্ধেই	বিরুদ্ধ
দেয়ালটি	দেয়াল
নদীর	নদী
সুরে	সুর
প্রদর্শনীটির	প্রদর্শন
টঙ্গিবাড়ী	টঙ্গিবাড়ী
কোরান	কোরান
সিসা	সিসা
জামিয়াতুল	জামিয়াতুল
অংশীদাররা	অংশ
নামলেও	নামল
শিপমেন্ট	শিপ
ফসলাদি	ফসল
সৌদিপ্রবাসী	সৌদি
বাড়েনি	বাড়ে
স্বাধীনভাবে	স্বাধীন
গ্রামীণ	গ্রাম
উন্নয়নও	উন্নয়ন
চাকমার	চাকমা
উপকরণগুলো	উপকরণ
সন্নিবিষ্ট	সন্নিবিষ্ট
ইউএসএস	ইউএসএস
ফেবারিট	ফেবারিট
বিস্তৃত	বিস্তৃত
মাহফিলে	মাহফিল
জন্মনিয়ন্ত্রণের	জন্ম
লেখাগুলো	লেখা
হাফপ্যান্ট	প্যান্ট
আয়রন	আয়রন
এনওয়াইএ	এনওয়াইএ
মুষ্টিযোদ্ধা	মুষ্টিযোদ্ধা
দোকানের	দোকান
চেঞ্জ	চেঞ্জ
সেন্টিমিটারের	সেন্টিমিটার
মোহসীন	মোহসীন
দেবকে	দেব
মাংসে	মাংস
আসাদ	আসাদ
লাইকেন	লাইকেন
অসহযোগিতা	সহযোগিতা
সুতো	সুতো
পেন	পেন
ঝর্ণার	ঝর্ণা
রেডিওর	রেডিও
গরিমা	গরিমা
বিদ্যমান	বিদ্যমান
চালকলের	কল
আইবেলা	আইবেলা
দেশত্যাগের	দেশ
আইতে	আইত
গিটার	গিটার
জেদের	জেদ
ইস্কান্দার	ইস্কান্দার
মেমোরির	মেমোরি
পরিবেশনা	পরিবেশ
অনুরোধগুলি	রোধ
বায়ুচলাচল	বায়ু
সহিষ্ণুতার	সহিষ্ণু
ধরতেন	ধর
ব্যবহারিকভাবে	ব্যবহার
কেনিয়া	কেনিয়া
পাসওয়ার্ডটি	পাসওয়ার্ড
চ্যাম্পিয়ান	চ্যাম্প
উদ্ধারকর্মী	উদ্ধারকর্মী
মুঠোফোন	ফোন
স্টকহোমে	স্টকহোম
ফিরআউন	ফিরআউন
তারিখও	তারিখ
খটকা	খটকা
ইসলামাবাদের	ইসলামাবাদ
ফুসলিয়ে	ফুসল
বিকেন্দ্রীকরণ	কেন্দ্রীকরণ
কাজেম	কাজ
লাইনটির	লাইন
ট্রান্সক্রিপশন	ট্রান্সক্রিপশন
বেঁধেছেন	বেঁধ
কিয়েভ	কিয়েভ
আকাদেমি	আকাদেমি
বলিভিয়ায়	বলিভিয়া
তরলতা	তরল
চরমপন্থীরা	চরমপন্থী
পরেছে	পরেছ
মক্তব	মক্তব
স্বর্গদেউ	স্বর্গ
ডেস্কটপের	ডেস্কটপ
প্রহরীর	প্রহরী
স্ক্রিনশট	স্ক্রিনশট
চাপটা	চাপটা
দুলালী	দুলাল
বলেশ্বর	বলেশ্বর
দফতরের	দফতর
খাটিয়ে	খাটি
ডেলিগেট	ডেলিগেট
ট্র্যাক্টর	ট্র্যাক্টর
সমৃদ্ধকরণ	সমৃদ্ধ
রেহেনা	রেহেনা
ঘূর্ণিঝড়	ঝড়
এওএল	এওএল
আইন	আইন
জিপিইউ	জিপিইউ
উইলসনের	উইলসন
কোমায়	কোমা
ফেলাই	ফেল
পশমি	পশম
রেডক্রসের	রেডক্রস
গুরুদাসপুর	গুরুদাসপুর
যতীন্দ্রমোহন	যতীন্দ্রমোহন
তামিলনাড়ু	তামিলনাড়ু
কিশোরীরা	কিশোরী
কতক্ষণ	কতক্ষণ
অজয়	অজয়
লড়াই	লড়াই
লিঙ্গবৈষম্য	লিঙ্গ
মালভূমির	মালভূমি
সময়ের	সময়
ডোমেস্টিক	ডোমেস্টিক
বীচ	বীচ
অনুসরণ	সরণ
কর্মক্ষমতা	কর্ম
আইনুল	আইনুল
গণসংযোগ	গণসংযোগ
উপসাগরে	উপসাগর
রবার্ট	রবার্ট
সদস্যরাই	সদস্য
দায়ী	দায়
ঐখানে	ঐখান
পঞ্চমবারের	পঞ্চম
মন্বন্তর	মন্বন্তর
কারুশিল্প	শিল্প
এইচটিসি	এইচটিসি
যুবদের	যুব
হুসেইন	হুসেইন
মার্কিনীদের	মার্কিন
রিয়াদ	রিয়াদ
পরায়ণ	পরায়ণ
পাসওয়ার্ডের	পাসওয়ার্ড
জব্বারকে	জব্বার
নিত্যানন্দ	নিত্য
নিলাম	নিলাম
পেনিনসুলার	পেনিনসুলা
সাদিকুর	সাদিকুর
অন্যতম	অন্য
এইচপিএ	এইচপিএ
ডুয়েল	ডুয়েল
খেলেছে	খেল
পরিণামের	পরিণাম
ভার্জিনিয়া	ভার্জিনিয়া
দিয়েই	দি
অস্ট্রেলিয়াকে	অস্ট্রেলিয়া
টেন্ডারবাজি	টেন্ডার
এমবিপিএস	এমবিপিএস
সোনিয়াকে	সোনিয়া
দুর্ভিক্ষ	দুর্ভিক্ষ
অগ্রগণ্য	গ্রগণ্য
হাতলের	হাতল
বিশ্ববিদ্যালয়ে	বিদ্যা
স্টেকহোল্ডারদের	স্টেকহোল্ডার
সিরাজগঞ্জ	সিরাজ
মোকাব্বির	মোকাব্বির
ভাবায়	ভাব
সুড়সুড়ি	সুড়সুড়ি
সুইডিস	সুইডিস
নাচানাচি	নাচা
নয়াবাজার	নয়াবাজার
বার	বার
রেডিওথেরাপি	থেরাপি
আইওয়া	আইওয়া
ব্যাপি	ব্যাপি
চাইবে	চাই
থিবো	থিবো
আধাসামরিক	সামরিক
অল্পদিন	অল্পদিন
বনানীতে	বনানী
ঢাকাতেই	ঢাকাতে
হটে	হটে
সুদানী	সুদান
জানাব	জান
বোস্টনে	বোস্টন
ডয়চে	ডয়চে
চাহিদাগুলো	চাহিদা
অস্থায়ীভাবে	স্থায়ী
জঘন্যতম	জঘন্য
তেজগাঁও	তেজগাঁও
নাছরিন	নাছরিন
ইনিংসটির	ইনিংস
আপিল	আপিল
পাকানো	পাকানো
হিন্দুস্থান	হিন্দু
পাশ	পাশ
পুতে	পুতে
উগ্রবাদীদের	উগ্র
সাদমান	সাদমান
অধিনায়ককে	নায়ক
মর্গ	মর্গ
বিপ্লবীর	বিপ্লব
ডোর	ডোর
ক্ষরিত	ক্ষর
মালদিনি	মালদিনি
স্যাটেলাইট	স্যাটেলাইট
গালীলের	গালীল
পারিনি	পার
মন্জুর	মন্জুর
পোড়ানো	পোড়া
হায়দরাবাদের	হায়দরাবাদ
ইয়র্কে	ইয়র্ক
রাইখা	রাইখ
বাংলোয়	বাংলো
দত্তপাড়া	দত্তপাড়া
নৃত্যশিল্পীরা	শিল্প
নিভু	নিভু
বালুবোঝাই	বালু
বাড়ায়	বাড়া
মজিদের	মজিদ
সুদানি	সুদান
স্টিরিও	স্টিরিও
বায়ুতে	বায়ু
বাজিয়েছেন	বাজিয়েছে
সদর্পে	সদর্প
গ্যাসে	গ্যাস
প্রভোস্ট	প্রভোস্ট
কিউবিক	কিউব
ধাঁধা	ধাঁধা
ঘরকে	ঘর
পার্কটি	পার্ক
ধুয়া	ধুয়া
সম্প্রদায়ভুক্ত	সম্প্রদায়
খোকামনি	খোকা
মধ্যের	মধ্যে
ম্যাচটি	ম্যাচ
কন্টিনিউয়িসিটি	কন্টিনিউয়িসিটি
এমএলসি	এমএলসি
প্রিয়	প্রিয়
আহমদিয়া	আহমদিয়া
টেম্পারিং	টেম্পারিং
শিবনারায়ণ	শিবনারায়ণ
কার্যবিধির	কার্যবিধি
দোলনচাঁপা	দোলনচাঁপা
টুর্নামেন্টে	টুর্নামেন্ট
ছিলাম	ছিল
নিরস্ত্রীকরণ	নিরস্ত্র
রসুলপুর	রসুলপুর
উইজডম	উইজডম
চর্বি	চর্বি
জ্বালান	জ্বালান
দেশ	দেশ
ঈশ্বরদীতে	ঈশ্বরদী
উল্লাসধ্বনি	উল্লাসধ্বনি
দখলদারিত্বের	দখলদারিত্ব
ততক্ষন	ততক্ষন
হেবেই	হেবে
কেয়ারটেকার	কেয়ারটেকার
স্প্যাম	স্প্যাম
ওয়াসিমের	ওয়াসিম
ছিটমহলে	মহল
পেশোয়ার	পেশোয়ার
এগ্রিকালচারাল	এগ্রিকালচার
প্রসিদ্ধ	প্রসিদ্ধ
শাস্তি	শাস্তি
মেশার	মেশা
ফিউশন	ফিউশন
ফিরছেন	ফিরছ
জয়ত্রী	জয়ত্রী
আবরণের	আবরণ
চরিতার্থ	চরিত
পন্ডিতরা	পন্ডিত
তিকা	তিকা
গুণটি	গুণ
নাজের	নাজের
সপ্তাহটা	সপ্তাহ
উত্তীর্ণদের	উত্তীর্ণ
গিলক্রিস্ট	গিলক্রিস্ট
তেজ	তেজ
ডায়াল	ডায়াল
রাজাকার	রাজাকার
প্রভিন্সের	প্রভিন্স
শহরগুলোর	শহর
ব্যান্ডটির	ব্যান্ড
স্বেচ্ছাসেবীর	স্বেচ্ছা
এনআর	এনআর
পূর্ণভাবে	পূর্ণ
সিরিয়ার	সিরিয়া
ছয়তলা	ছয়
হেলথের	হেলথ
বরঞ্চ	বরঞ্চ
তিনভাগে	তিন
জেসপার	জেসপার
ভুইয়া	ভুইয়া
দর্শনার্থীদের	দর্শনার্থী
চলাই	চল
আইনসঙ্গত	আইন
মনটা	মন
বাস্তবতার	বাস্তব
নির্বাচনকালে	নির্বাচন
অচেনা	চেনা
দুটোকেই	দুটো
রুল্	রুল
রুলস	রুল
আসামির	আসামি
লেখনী	লেখনী
হেলাল	হেলাল
প্রেজেন্ট	প্রেজেন্ট
প্রবাসীর	প্রবাস
সিদ্দিকির	সিদ্দিকি
অবতারণ	অবতার
বিবিকে	বিবি
নাশ	নাশ
নিঃশ্বাস	শ্বাস
ইমামদের	ইমাম
মাদানী	মাদানী
অনুযায়ীই	অনুযায়ী
গোলাপ	গোলাপ
একুশের	একুশ
উপঢৌকন	উপঢৌকন
ছাত্রজীবন	জীবন
গ্লোব	গ্লোব
হলের	হল
প্রিয়তম	প্রিয়তম
প্রকৃতিগতভাবে	প্রকৃতি
সেইসব	সব
পিআই	পিআই
আঙ্গুরের	আঙ্গুর
কারেন্সি	কারেন্সি
গ্রিলের	গ্রিল
প্রাণোচ্ছল	প্রাণোচ্ছল
বিজ্ঞানীরা	বিজ্ঞানী
অশরীরী	শরীর
মডিউলের	মডিউল
রামপাল	রামপাল
ভোটার	ভোট
আবহ	আবহ
সতীনাথ	সতীনাথ
রেজোলিউশনে	রেজোলিউশন
পট্টি	পট্টি
অযৌক্তিকভাবে	যৌক্তিক
সমতলকে	সমতল
রাইফেলে	রাইফেল
সুরেই	সুর
সম্মুখভাগ	সম্মুখ
বিরামহীন	বিরাম
বলটা	বল
টাকার	টাকা
গ্রানাডা	গ্রানাডা
আলোকচ্ছটা	আলোকচ্ছটা
ব্যাপ্টিস্ট	ব্যাপ্টিস্ট
খুনী	খুন
স্বঘোষিত	ঘোষিত
আপ্রাণ	প্রাণ
মামাদের	মামা
চোরদের	চোর
ঝাড়ুদার	ঝাড়ু
অস্ট্রেলিয়ানদের	অস্ট্রেলিয়া
গাছ	গাছ
ভাতার	ভাতা
এইট	এই
মর্যাদাপূর্ণ	মর্যাদা
বিভাগটির	বিভাগ
শিমুল	শিমুল
সমাজকল্যাণমূলক	সমাজ
গরুটি	গরু
মূল্যবোধ	মূল্য
থার্মোস্ট্যাট	থার্মোস্ট্যাট
উভয়েই	উভয়
কম্প্রেশন	কম্প্রেশন
জেরাল্ড	জেরাল্ড
মাতা	মা
অববাহিকা	অববাহিকা
অনেকাংশ	অনেক
স্লোগানকে	স্লোগান
নিলেন	নিল
আমলেই	আমল
গালিচায়	গালিচা
বায়োলজি	বায়োলজি
ঋণও	ঋণ
অভিপ্রায়ে	অভিপ্রায়
কাটাকাটি	কাটাকাটি
ক্ষমাহীন	ক্ষমা
জাবের	জাব
নাচি	নাচ
বাংকার	বাংকার
এনআইডি	এনআইডি
বালি	বালি
তিহীন	তিহীন
ক্রোমিয়াম	ক্রোমিয়াম
সেনবাগ	সেনবাগ
কেসে	কেস
কানপুর	কানপুর
সাগা	সাগা
নিরাময়	নিরাময়
মর্টগেজ	মর্টগেজ
নিঃসন্দেহ	সন্দেহ
তাঁকেই	তাঁকে
আরো	আরো
ফেরদৌস	ফেরদৌস
গিলতে	গিল
যেত	যেত
একজোড়া	একজোড়া
আয়োজকদের	আয়োজক
সের	সের
মাসির	মাসি
এঞ্জেলা	এঞ্জেলা
আইনসহ	আইন
মাঝামাঝি	মাঝ
রানওয়েতে	রানওয়ে
চলচ্চিত্রায়িত	চলচ্চিত্র
গাঁটছড়া	গাঁটছড়া
লড়েছে	লড়ে
আবে	আবে
নির্যাতনকারী	নির্যাতন
অত্যাচারিত	অত্যাচারিত
কল্যাণপুরে	কল্যাণ
ঋণদাতাদের	ঋণ
জমিটি	জমি
চলচ্চিত্রাঙ্গনে	চলচ্চিত্রাঙ্গন
সিরিয়াসলি	সিরিয়াস
সংকটকে	সংকট
ডাইভার	ডাইভার
দুটোতে	দুটো
দ্বীপ	দ্বীপ
মোশাররফের	মোশাররফ
অসতর্ক	সতর্ক
বর্গাকৃতির	বর্গ
গ্লাভস	গ্লাভস
চট্টগ্রামে	চট্টগ্রাম
হ্যালির	হ্যালির
মামাতো	মামা
নের	নের
করলএবং	কর
হ্যান্ডসকম্ব	হ্যান্ড
থাকছেই	থাক
ওয়ান্ডা	ওয়ান্ডা
সখী	সখী
আটজন	আট
যাত্রাটা	যাত্রা
ব্যাংকেও	ব্যাংক
ভাইরাসটি	ভাইরাস
মানজনক	মানজনক
মাথাব্যথা	মাথাব্যথা
অধ্যুষিত	অধ্যুষিত
স্বরের	স্বর
স্ক্রীণ	স্ক্রীণ
বেয়ার	বেয়ার
বোরের	বোর
হুঁশিয়ার	হুঁশিয়ার
মোসাদ	মোসাদ
ইরাকী	ইরাক
পুড়ে	পুড়ে
লন্ডনভিত্তিক	লন্ডন
দ্বিপক্ষীয়	পক্ষ
দেখিয়ে	দেখ
মায়ের	মা
পরিষদে	পরিষদ
তাইওয়ান	তাইওয়ান
নালিশ	নালিশ
সামান্যই	সামান্য
টাউনে	টাউন
লেখকগণের	লেখক
বিধবাকে	বিধবা
রেহমানকে	রেহমান
সত্যি	সত্য
সাইবেরিয়ার	সাইবেরিয়া
ভ্রমণকাহিনী	ভ্রমণকাহিনী
উপজেলাকে	উপজেলা
নাগপুরের	নাগ
হিন্দুর	হিন্দু
গোলই	গোলই
ব্রোশারটি	ব্রোশার
মেধাবী	মেধা
লেন্সিং	লেন্স
কার্যকারণ	কার্য
চিপ	চিপ
পেশাদারিত্বের	পেশা
বড়ি	বড়ি
ফেরতযোগ্য	ফেরত
পর্ষদকে	পর্ষদ
বাধিত	বাধিত
সারাদিনের	সারাদিন
স্বল্পমেয়াদি	স্বল্প
আর্মস্ট্রং	আর্মস্ট্রং
যাত্রীবেশে	যাত্রী
ফেরো	ফের
পাপকে	পাপ
যুদ্ধেও	যুদ্ধ
নিরলসভাবে	নিরলস
কোল্লাম	কোল্লাম
চার্চের	চার্চ
ধাঁচে	ধাঁচ
গৃহের	গৃহ
আত্ম	আত্ম
সিন্দবাদ	সিন্দবাদ
উত্পত্তি	উত্পত্তি
কর্মসূচী	কর্ম
হাউমাউ	হাউ
নারীবাদী	নারীবাদ
করাগ	করাগ
বিশ্বজনীন	বিশ্ব
পয়েন্টে	পয়েন্ট
রকম	রকম
সখিনা	সখিনা
আশুলিয়ায়	আশুলিয়া
ব্যাসার্ধ	ব্যাসার্ধ
লবন	লবন
দামেস্কে	দামেস্ক
প্রতিবেদককে	প্রতিবেদক
এআই	এআই
দীক্ষিত	দীক্ষ
রাত্রিকালীন	রাত্রি
সদরে	সদর
চিন্তাগুলো	চিন্তা
এনএইচএস	এনএইচএস
দুর্নীতিপরায়ণ	দুর্নীতি
শিল্পীকে	শিল্পী
ছড়ার	ছড়া
বিচ	বিচ
বাধাদান	বাধা
টেলিকম	টেলিকম
বেদনাহত	বেদনা
শিশুকল্যাণ	শিশু
মঙ্গোলিয়ান	মঙ্গোলিয়া
জেমসকে	জেমস
বন্ধুসুলভ	বন্ধু
গুলজারের	গুল
প্রশাসনের	শাসন
হ্যান্ডলার	হ্যান্ডলার
করোনা	করোনা
প্রয়োগকৃত	প্রয়োগ
উদয়ের	উদয়
ছেড়েছে	ছেড়েছে
করদাতাকে	করদাতা
অনির্দিষ্টকালের	অনির্দিষ্টকাল
বুর্জ	বুর্জ
আগ্রাসী	আগ্রাসী
পোড়াও	পোড়া
বভরে	বভরে
প্রশাসককে	শাসক
স্বর্গদূত	স্বর্গ
সিঁড়িতে	সিঁড়ি
বার্মায়	বার্মা
বর্ডারস	বর্ডার
হাবিবুল্লাহ	হাবিবুল্লাহ
বিয়েই	বিয়ে
ট্রান্সলেশন	ট্রান্সলেশন
ইন্দ্র	ইন্দ্র
অ্যাসিডে	অ্যাসিড
পদচিহ	পদ
ইদুর	ইদুর
চিলড্রেনের	চিলড্রেন
মঈনুদ্দিন	মঈন
থাইল্যান্ড	থাইল্যান্ড
জোগাচ্ছেন	জোগাচ্ছ
আকৃতিতে	আকৃতি
যৌগটি	যৌগ
পাকিস্তানে	পাকিস্তান
কামরায়	কামরা
কালচারের	কালচার
জোয়ানা	জোয়ানা
ত্রিমোহনী	ত্রিমোহনী
অসহায়	অসহায়
পাততে	পাত
ডোবার	ডোবা
দুজনে	জন
ভাবাদর্শ	ভাবাদর্শ
খালেককে	খালেক
সিনিয়রদের	সিনিয়র
ভাইভা	ভাইভা
হামিদুল	হামিদুল
ব্যর্থতায়	ব্যর্থতা
ওয়ারিয়র	ওয়ারিয়র
সুচারুরূপে	সুচারু
রিসেসড	রিসেস
চাবিকাঠি	চাবি
আক্রমণকে	আক্রমণ
পুওর	পুওর
ট্যাবলেটে	ট্যাবলেট
গাংনীতে	গাংনী
শহরটি	শহর
প্রতিক্রিয়া	ক্রিয়া
হাউজের	হাউজ
ডিজাইনাররা	ডিজাইনার
দিশারী	দিশা
কুড়ানো	কুড়ানো
বিপিএল	বিপিএল
জাভি	জাভি
রাষ্ট্রভাষার	রাষ্ট্র
পুনঃনির্মাণ	পুনঃনির্মাণ
নামক	নাম
সর্বজনের	সর্বজন
শরৎচন্দ্রের	শরৎচন্দ্র
আহোম	আহোম
সন্ত্রাসবাদ	সন্ত্রাসবাদ
গোসলের	গোসল
আসমাউল	আসমাউল
দুলতে	দুলত
অবিন্যস্ত	বিন্যস্ত
নিপীড়নের	নিপীড়ন
মাঝনদীতে	নদী
ভাববাদীর	ভাব
হিলারী	হিলারী
কর্মচারীবৃন্দ	কর্ম
সংযত	সংযত
মনোয়ারা	মনোয়ারা
প্লাস্টিকের	প্লাস্টিক
চারতলায়	চার
মাল্টায়	মাল্টা
বোতলজাত	বোতল
কনকাকাফ	কনকাকাফ
ভূস্বামী	ভূস্বামী
ঢেঁকি	ঢেঁকি
স্তরযুক্ত	স্তর
কৃষ্ণমূর্তি	কৃষ্ণমূর্তি
চাচারা	চাচা
পরিশোধক	শোধক
অ্যাসিস্ট্যান্ট	অ্যাসিস্ট্যান্ট
বুলবুলকে	বুলবুল
যুবা	যুব
গোনা	গোনা
বার্মার	বার্মা
সোলেমান	সোলেমান
অর্পিতা	অর্পিত
যাক	যাক
শিক্ষাও	শিক্ষা
মহিমাগঞ্জ	মহিমাগঞ্জ
টেরিজা	টেরিজা
গোছানো	গোছানো
স্বাস্থ্যকে	স্বাস্থ্য
অন্যভাবে	অন্য
প্রচারকে	প্রচার
বন্ধুত্বে	বন্ধু
আধুনিককালের	আধুনিককাল
প্রশ্নেরও	প্রশ্নের
মামা	মামা
পিক্সেল	পিক্সেল
মার্চেন্টস	মার্চেন্ট
করিতে	কর
নারীরা	নারী
জাহাঙ্গীর	জাহাঙ্গীর
দোকানটি	দোকান
সাক্ষিকে	সাক্ষি
মুস্তাফিজুর	মুস্তাফিজুর
প্রতিকারে	প্রতিকার
মিলিয়নেরও	মিলিয়ন
স্থান	স্থান
অকর্মণ্য	অকর্মণ্য
সাতজনই	সাতজন
বহুবর্ষজীবী	বহুবর্ষ
কোয়া	কোয়া
বাবুর্চির	বাবুর্চি
অবর্ণনীয়	বর্ণ
আত্মসমালোচনা	আত্মসমালোচনা
শেষোক্তটি	শেষ
বইকে	বই
রোজকার	রোজ
কানেটিকাট	কানেটিকাট
সংগঠনগুলোও	গঠন
আপত্তিতে	আপত্তি
ধ্বংসাত্মক	ধ্বংস
টপিক	টপিক
ধর্মকর্ম	ধর্মকর্ম
পূর্বপাড়া	পাড়া
সভাপতিকে	সভাপতি
শিক্ষাগ্রহণের	শিক্ষা
নিজেস্ব	নিজ
হবিগঞ্জের	হবিগঞ্জ
অনুচ্ছেদের	অনুচ্ছেদ
দায়িত্বপ্রাপ্ত	দায়
নির্বাচনমুখী	নির্বাচন
ওবামাকেয়ার	ওবামাকেয়ার
ডাচ	ডাচ
পোষন	পোষ
কইরো	কইরো
বানায়	বানায়
চিকিৎসালয়	চিকিৎসা
পৃষ্ঠতলের	পৃষ্ঠতল
আওয়াজে	আওয়াজ
বুকটা	বুক
তিনজনই	তিনজন
ঘূর্ণিঝড়ের	ঘূর্ণিঝড়
ভক্তেরা	ভক্ত
নিকাশ	নিকাশ
ইগল	ইগল
আদর্শবাদী	আদর্শ
বহুবিবাহের	বহুবিবাহ
থেমেছে	থেমে
বাহারছড়া	বাহারছড়া
এক্সএক্সএক্স	এক্সএক্সএক্স
প্রিমিয়ার	প্রিমিয়ার
বেত্রাঘাতের	বেত্র
এক্সাইজ	এক্সাইজ
নেছার	নেছার
ছড়ায়	ছড়া
অনুষ্ঠানেও	অনুষ্ঠান
পিকনিক	পিকনিক
অঘটন	অঘটন
রাজউকের	রাজউক
ব্রেকআউট	ব্রেকআউট
ভূমিকম্পটির	ভূমিকম্প
অতল	অতল
ক্যাম্পেইনে	ক্যাম্পেইন
মান্দার	মান্দার
দাঁতভাঙা	দাঁত
প্রতিক্রিয়াগুলি	প্রতিক্রিয়া
অনেকেই	অনেক
ফুৎকার	ফুৎকার
ডনের	ডন
এলিসা	এলিসা
কম্পোজিশন	কম্পোজিশন
খুদা	খুদা
মেয়েশিশুর	শিশু
স্যারেরা	স্যার
বেজন্মা	জন্ম
মাখামাখি	মাখা
ভূমিধসে	ভূমি
আলোটা	আলো
প্রেরণা	প্রেরণা
চিকিৎসকেরাও	চিকিৎসক
হামিদপুর	হামিদ
মাহ্ফুজ	মাহ্ফুজ
স্মৃতিগুলো	স্মৃতি
সূত্রের	সূত্র
সরোয়ার	সরোয়ার
সেলিনার	সেলিনা
লাইবেরিয়া	লাইবেরিয়া
কমান্ডো	কমান্ডো
স্ফীতিশীলতামূলক	স্ফীতি
সিমস	সিম
আলুর	আলু
পরিপ্রেক্ষিতেই	পরিপ্রেক্ষি
সাহিত্যিকদের	সাহিত্য
সেন্সরে	সেন্সর
ট্র্যাফিক	ট্র্যাফিক
বিভাগে	ভাগ
মসজিদ	মসজিদ
ক্লাউডে	ক্লাউড
নিষেধের	নিষেধ
আলোকচিত্র	চিত্র
অনিষ	অনিষ
সাদি	সাদি
স্তম্ভিত	স্তম্ভিত
দার্শনিক	দার্শন
ব্যালেন্স	ব্যালেন্স
হিগস	হিগস
নিম্নবর্ণের	নিম্ন
ক্রুসেড	ক্রুসেড
লাঘবের	লাঘব
টিকিট	টিকিট
রিকশায়	রিকশা
ছয়টায়	ছয়
সমাজকল্যাণ	সমাজকল্যাণ
প্রকৃতিবাদ	প্রকৃতি
আশেক	আশেক
ধীরেন	ধীরেন
ফেইস	ফেইস
ধাক্কাধাক্কি	ধাক্কা
লুসাই	লুসাই
কমও	কম
ইখতিয়ার	ইখতিয়ার
রুপির	রুপি
জাওয়াদ	জাওয়াদ
কথাশিল্পী	কথাশিল্পী
মায়েদের	মা
শেফার্ড	শেফার্ড
শ্বাসাঘাত	শ্বাস
হ্যাক	হ্যাক
ছায়াপথগুলোর	ছায়া
শোকেসে	শোকেস
মুদ্রাগুলির	মুদ্রাগুল
হারামের	হারাম
ব্রাইড	ব্রাইড
নামানুসারে	নাম
ফ্লয়েড	ফ্লয়েড
রাকিবুল	রাকিবুল
নৈতিকতাকে	নৈতিক
ক্রসিংয়ে	ক্রসিং
ল্যাবরেটরি	ল্যাবরেটরি
ছাপার	ছাপা
উত্তরার	উত্তর
মননের	মনন
কম্পাস	কম্পাস
স্থানান্তর	স্থান
লুট	লুট
টারপলিন	টারপলিন
ঠেলাঠেলি	ঠেলা
বাক্প্রতিবন্ধী	বন্ধ
ভুলু	ভুল
লায়ন	লায়ন
মোঙ্গল	মোঙ্গল
খেয়াল	খেয়াল
বিরহ	বিরহ
এগারো	এগারো
আনোয়ারুল	আনোয়ারুল
স্তবকগুলোর	স্তবক
নুডল	নুডল
কিচেনে	কিচেন
রাউন্ডার	রাউন্ড
পিন্টো	পিন্ট
হতবুদ্ধি	হতবুদ্ধি
বিপাকে	বিপাক
বনাঞ্চল	বন
ফর্মালডিহাইড	ফর্মালডিহাইড
কর্মস্থল	কর্মস্থল
পাঠিয়েছেন	পাঠিয়ে
মুনশী	মুনশী
গুপ্তধন	গুপ্ত
হিমাচল	হিমাচল
ব্যাটসম্যানের	ব্যাটসম্যান
ভবের	ভব
বানিয়ে	বানিয়ে
বর্ণহীন	বর্ণ
গল্পও	গল্প
কংগ্রেসে	কংগ্রেস
ক্লিনিং	ক্লিন
রাবিয়া	রাবিয়া
গাগা	গাগা
বেকসুর	কসুর
জেনিরোর	জেনিরো
নাৎসিরা	নাৎসি
রেজিস্ট্রার	রেজিস্ট্রার
এগুলো	এগুলো
সিঙ্গাপুরে	সিঙ্গাপুর
আহতের	আহত
অর্থমন্ত্রী	অর্থ
পাবো	পাবো
অগ্রাধিকারমূলক	অগ্রাধিকার
মানবেন	মানবে
মহাত্মা	মহাত্মা
এদেশীয়	দেশ
মিউজিকের	মিউজিক
প্রান্তে	প্রান্ত
মেয়ের	মেয়ে
উপদ্বীপকে	দ্বীপ
সালিসী	সালিস
প্লাগিন	প্লাগিন
ওয়ার্কস	ওয়ার্ক
গ্রাম্য	গ্রাম
আমলা	আমলা
হংকংকে	হংকং
উভকামী	কামী
বাল্ব	বাল্ব
এলইডি	এলইডি
ম্যাচগুলোয়	ম্যাচ
ওয়ান	ওয়ান
প্ল্যাটফর্মগুলি	প্ল্যাটফর্ম
সদরঘাটে	সদরঘাট
ম্যাসি	ম্যাসি
রাক্ষুসে	রাক্ষুস
সিমুলেটেড	সিমুলেটেড
কোটি	কোটি
স্কুলে	স্কুল
সংসর্গে	সর্গ
ফিজিওথেরাপি	ফিজিওথেরাপি
ক্যানন	ক্যানন
প্রয়োজনে	প্রয়োজন
ট্রান্সসিভার	ট্রান্সসিভার
হারবে	হার
জেসি	জেসি
কূল	কূল
আযীয	আযীয
ব্যথাও	ব্যথা
সাজালে	জাল
দৃষ্টিতে	দৃষ্টি
তাবুর	তাবু
প্রতিশ্রুতিকে	প্রতিশ্রুতি
হানতে	হানতে
মেয়েদেরকে	মেয়ে
সুখকে	সুখ
ব্র্যান্ডগুলোর	ব্র্যান্ড
মাধ্যমিকের	মাধ্যমিক
শাং	শা
ফখরুজ্জামান	ফখরুজ্জামান
অপরূপা	অপরূপা
নির্দেশনাকে	নির্দেশনা
চোটে	চোট
মাজারে	মাজার
জিসি	জিসি
মৃত্যুদন্ডের	মৃত্যু
মুছা	মুছ
তাঁহাতে	তাঁহা
কালিদাসের	কালিদাস
পণ্যটিতে	পণ্য
নকআউট	নকআউট
অবাধ্য	বাধ্য
সবেচেয়ে	সবেচেয়ে
স্টাইলিং	স্টাইল
অনেকগুলিই	অনেক
উপকমিটি	কমিটি
পীড়াপীড়ি	পীড়া
জুতসই	সই
রায়পুরা	রায়পুরা
পদগুলির	পদ
ঘটনাটি	ঘটনা
মিরিক	মিরিক
দ্রাবক	দ্রাবক
ইসকোর	ইস
চাপই	চাপ
টার্নকি	টার্নকি
সিটিসেলের	সিটি
পরিবর্তনগুলোর	পরিবর্তনগুলো
খতিয়ে	খতিয়ে
পিঠে	পিঠে
দ্রষ্টব্য	দ্রষ্টব্য
বিনয়াবনত	বিনয়
দৈব	দৈব
অর্থোপেডিক	অর্থোপেডিক
আমৃত্যু	মৃত্যু
লড়ছেন	লড়ছে
অ্যানালিস্ট	অ্যানালিস্ট
তুলল	তুলল
সার্জিও	সার্জিও
লোটার	লোটা
মেহেরপুর	মেহেরপুর
খাদেম	খাদেম
ক্যাথোড	ক্যাথোড
ভালোবাসাকে	ভালোবাসা
রাষ্ট্রগুলো	রাষ্ট্র
এ্যাওয়ার্ড	এ্যাওয়ার্ড
বোঝ	বোঝ
কনসোর্টিয়ামের	কনসোর্টিয়াম
ওয়াইম্যাক্স	ওয়াইম্যাক্স
সম্ভবনা	সম্ভবনা
হ্যামিল্টনে	হ্যামিল্টন
সম্মানও	সম্মান
অ্যাপলেট	অ্যাপলেট
হুইপের	হুইপ
পেঙ্গুইন	পেঙ্গুইন
মোস্ট	মোস্ট
ওয়াটকিন্স	ওয়াটকিন্স
স্কাল	স্কাল
টিথ	টিথ
উদ্দিনের	উদ্দিন
পার্পল	পার্পল
পৌঁছাই	পৌঁছা
ফিরেছে	ফিরেছে
সুলায়মান	সুলায়মান
জন্মও	জন্ম
নিশ্চিতে	নিশ্চিত
সময়ক্ষেপণ	সময়ক্ষেপণ
অটোয়া	অটোয়া
রাশিয়ান	রাশিয়া
সাঁতরে	সাঁতরে
দিনটি	দিন
মনের	মন
কলাবাগানের	কলা
সোর্সিং	সোর্স
প্রতিভা	প্রতিভা
সংকলনটি	সংকলন
শিন	শিন
আইডিতে	আইডি
হলো	হলো
সহায়তায়	সহায়তা
নেতিবাচক	নেতি
জন্মকালীন	জন্ম
সাজিয়েছে	সাজিয়ে
যাত্রীছাউনি	যাত্রী
এককটি	এক
হওয়াতেই	হওয়া
ফর্মুলার	ফর্মুলা
ব্রিজের	ব্রিজ
পাসপোর্টের	পাসপোর্ট
থাপ্পড়	থাপ্পড়
আন্দ্রেই	আন্দ্র
বধূ	বধূ
সৎকারের	সৎকার
হত্যাকাণ্ড	হত্যা
বস্তির	বস্তি
একগুঁয়েমি	একগুঁয়েমি
ইসলামপুরের	ইসলামপুর
অবকাশের	অবকাশ
নাট্যচর্চা	নাট্য
ল্যাম্পের	ল্যাম্প
উপরিস্থ	উপরিস্থ
পুত্ররূপে	পুত্র
অহঙ	অহঙ
হ্যাম্পশায়ার	হ্যাম্পশায়ার
সামাঞ্জস্যহীন	সামাঞ্জস্য
উদ্যোক্তাকে	উদ্যোক্তা
ভিক্ষুকে	ভিক্ষুক
ছাড়লেও	ছাড়
বিষক্রিয়ার	বিষক্রিয়া
অংশগ্রহণকে	অংশগ্রহণ
রাখব	রাখ
ব্যক্তিবর্গের	ব্যক্তি
হিলিয়াম	হিলিয়াম
লোহাগড়ার	লোহা
প্যাট	প্যাট
ইত্তেহাদ	ইত্তেহাদ
পাকিস্তানপন্থী	পাকিস্তান
হেরিটেজ	হেরিটেজ
গার্মেন্ট	গার্মেন্ট
সংবাদমাধ্যম	সংবাদ
জনমিতি	জনমিতি
গগন	গগন
ধূপ	ধূপ
জগন্নাথ	জগন্নাথ
লভ্যাংশ	লভ্যাংশ
ময়েশ্চারাইজার	ময়েশ্চারাইজ
বিষণ্ণতা	বিষণ্ণ
হজে	হজ
কোম্পানীগঞ্জে	কোম্পানী
গ্যারান্টি	গ্যারান্টি
কাউচ	কাউচ
ক্ষয়ক্ষতি	ক্ষয়ক্ষতি
ক্ষিপ্র	ক্ষিপ্র
লাগেনি	লাগে
পারলো	পারলো
দশমিনা	দশমিনা
শ্যামবাজারের	শ্যামবাজার
নেতারাও	নেতা
নিয়োগকৃত	নিয়োগ
অধীনস্ত	অধীন
বাসীদেরকে	বাসী
হামলা	হামলা
জমিদারগণ	জমিদার
আহার	আহার
জরা	জরা
উমেশচন্দ্র	উমেশচন্দ্র
বাহ্যিক	বাহ্যিক
আমতলীর	আমতলী
প্রতিযোগিতায়ও	প্রতিযোগিতা
ঐক্যজোটের	ঐক্য
ভালোর	ভালো
সংযোগগুলি	সংযোগ
দৃষ্টিসীমার	দৃষ্টিসীমা
উপকরন	উপকরন
নিজেরাও	নিজে
মৌটুসি	মৌটু
ছোলা	ছোলা
কোমল	কোমল
কান্দাহারে	কান্দাহার
শুভেচ্ছার	শুভেচ্ছা
অনাদিকাল	অনাদি
আংলং	আংলং
আহাজারি	আহাজারি
পশ্চাৎপদ	পশ্চাৎপদ
লিখলাম	লিখলাম
গঞ্জালেজ	গঞ্জ
পারছো	পার
মিসবাহউদ্দিন	মিসবাহউদ্দিন
সল্প	সল্প
লগ্নি	লগ্নি
আয়ত্ত	আয়ত্ত
মাউথ	মাউথ
লুইজি	লুইজ
পরিশীলিত	পরিশীলিত
আমেনার	আমেনা
হরহামেশা	হরহামেশা
বালাহ	বালাহ
গ্রহনের	গ্রহন
ধর্ষনের	ধর্ষন
কূটনীতিক	কূট
প্রশ্নাতীত	প্রশ্ন
পূরণযোগ্য	পূরণ
নির্দেশনাও	নির্দেশনা
ফক্সকন	ফক্সকন
অযুত	অযুত
দুস্থ	দুস্থ
টরন্টোতে	টরন্টো
প্ল্যান	প্ল্যান
বিনিয়োগকে	বিনিয়োগ
কখনো	কখনো
পরিচালককে	পরিচালক
এংরেজ	এংরেজ
ত্রুটি	ত্রুটি
হেভেন	হেভেন
বায়ুবাহিত	বায়ু
পণ্যটি	পণ্য
বাঁশ	বাঁশ
করপোরেট	করপোরেট
সমাধানগুলির	সমাধান
দৌড়ানোর	দৌড়ানো
জেদ্দার	জেদ্দা
মামলায়	মামলা
ছয়জনকে	ছয়জন
সিস্টেমটি	সিস্টেম
বন্দুকধারীর	বন্দুক
দুটোর	দুট
যাঁহারা	যাঁহা
খাওয়ায়	খাওয়া
বিশ্ববাজারে	বিশ্ববাজার
বৈচিত্রময়	বৈচিত্র
ভালুকা	ভালুকা
পামার	পামার
ইউনানি	ইউনানি
শাসিয়ে	শাসিয়ে
পতাকা	পতাকা
ম্যাগাজিনটি	ম্যাগাজিন
প্রাইড	প্রাইড
উসূলে	উসূল
রিংস	রিং
কালভার্টের	কালভার্ট
ঢিলা	ঢিল
বছরেরই	বছর
মিয়া	মিয়া
রাজহাঁস	রাজহাঁস
মহাকাব্যে	মহাকাব্য
দিনমজুরি	মজুরি
ছাত্রীর	ছাত্রী
মাইক্রোবাসের	মাইক্রোবাস
জুতার	জুতা
ক্ষেত্রেও	ক্ষেত্র
রঙা	রঙ
ফেলছি	ফেলছি
অ্যাট্রিবিউট	অ্যাট্রিবিউট
আবেশন	আবেশ
তথ্যভান্ডারের	তথ্য
জলরঙে	জলরঙ
সংখ্যা	সংখ্যা
লেমন	লেমন
অনেকাংশেই	অনেকাংশ
প্রপার্টি	প্রপার্টি
রুহানি	রুহ
বিচির	বিচি
নেলসন	নেলসন
কিশোরকে	কিশোর
শরবতের	শরবত
অঞ্চলে	অঞ্চল
তাদেরকেই	তাদের
ফরওয়ার্ডিং	ফরওয়ার্ড
দৃশ্যমান	দৃশ্য
বাড়ানোর	বাড়া
ভূগর্ভে	ভূগর্ভ
নিবেদিতা	নিবেদিত
বিমোচনে	বিমোচন
স্বেচ্ছাচারী	স্বেচ্ছাচার
এয়ারলাইনস	এয়ারলাইনস
পিষ্ট	পিষ্ট
ঘড়ি	ঘড়ি
রাজাকারদের	রাজাকার
কাপল	কাপল
অগ্রগতির	অগ্রগতি
ফ্লোরোসেন্ট	ফ্লোরোসেন্ট
ট্রান্সফার	ট্রান্সফার
জন্মহার	জন্ম
গালিচার	গালি
নির্বাচনোত্তর	নির্বাচন
আক্রমণভাগের	আক্রমণ
ফরোয়ার্ড	ফরোয়ার্ড
উপদেষ্টারা	উপদেষ্টা
প্রবন্ধগুলি	প্রবন্ধ
বর্তায়	বর্তা
অনুন্নয়ন	অনুন্নয়ন
করিয়াছেন	করিয়া
ম্যাক্স	ম্যাক্স
ভোটাধিকার	ভোটাধিকার
শ্রমিকনেতারা	শ্রমিক
দুর্গন্ধযুক্ত	দুর্গন্ধ
মুল্যবান	মুল্য
রাষ্ট্রদূতদের	রাষ্ট্র
গ্লাইকোল	গ্লাইকোল
সুশীলা	সুশীল
স্বামীসহ	স্বামী
বুড়িমারী	বুড়িমারী
বৃহত্তম	বৃহত
পরিবারবর	পরিবার
গ্রন্থাগার	গ্রন্থাগার
আরএফএলের	আরএফএল
ভিজিয়ে	ভিজ
মন্ত্রনালয়	মন্ত্র
এইস	এইস
নির্বাচনেও	নির্বাচন
পরিসংখ্যানবিদ	পরিসংখ্যান
ওয়ার্ল্ড	ওয়ার্ল্ড
রেকর্ডটি	রেকর্ড
তরবারি	তরবারি
পাঁচটা	পাঁচ
ডিভিডি	ডিভিডি
মুহূর্তের	মুহূর্ত
কাঠিতে	কাঠ
বীভৎস	বীভৎস
দস্যুদের	দস্যু
উপকরণগুলির	উপকরণ
গৌড়ীয়	গৌড়ীয়
রৌদ্রোজ্জ্বল	রৌদ্র
মধ্যপাড়া	মধ্যপাড়া
চলচ্চিত্রে	চলচ্চিত্র
ডাকিনীবিদ্যা	ডাকিনী
নাদিয়া	নাদিয়া
সেটকে	সেট
খারাবি	খারাবি
গেভিন	গেভিন
এলাকায়	এলাকা
কর্মবিরতি	কর্মবিরতি
গ্যালারী	গ্যালারী
নজিপুর	নজিপুর
ঠাকুমা	ঠাকুমা
বেলজিয়ামে	বেলজিয়াম
গানটিকে	গান
জিতের	জিত
অধ্যাপকের	অধ্যাপক
গালফ	গালফ
প্রেসবক্সে	প্রেসবক্স
বুবলি	বুবলি
মহুয়ার	মহুয়া
চিকিৎসা	চিকিৎসা
অপ্রাসঙ্গিক	প্রাসঙ্গিক
পরিজনবর্গের	পরিজনবর্গ
কন্তে	কন্তে
লড়াইও	লড়া
শোয়েবের	শোয়েব
লিন্ডে	লিন্ড
পারসেন্ট	পারসেন্ট
শীতলকরণ	শীতল
তারাই	তার
ম্যামথের	ম্যাম
ইটভাটার	ইট
জানাটা	জানা
জমাচ্ছে	জম
ফান্ডেড	ফান্ডেড
আমানতের	আমানত
ঢোক	ঢোক
নিকাহ	নিকাহ
মুম্বাইয়ের	মুম্বাই
বিবাহবিচ্ছেদ	বিবাহবিচ্ছেদ
রহুল	রহুল
প্রতিহিংসা	হিংসা
পর্বের	পর্ব
পরিচ্ছন্নতাকর্মীদের	পরিচ্ছন্ন
ক্রি	ক্রি
বিদ্রূপাত্মক	বিদ্রূপ
হউন	হউ
আকস	আকস
শায়িত	শায়িত
ভেবেও	ভেবে
শিশুসুলভ	শিশু
রাজশাহীর	রাজশাহী
প্রোভাইডার	প্রোভাইডার
বিদ্যুৎস্পৃষ্ট	বিদ্যুৎ
হালি	হালি
পিরোজপুরের	পিরোজপুর
ছাত্রীটির	ছাত্র
কালীপ্রসন্ন	কালীপ্রসন্ন
নির্মাণশৈলীর	নির্মাণ
বিএসএফের	বিএসএফ
লাদাখের	লাদাখ
ভিটায়	ভিটা
উজানটিয়া	উজানটিয়া
দেওবন্দে	দেওবন্দ
ভূতদের	ভূত
আড়ং	আড়ং
দানশীলতা	দানশীল
দেশপ্রেমে	দেশ
কোচকে	কোচ
বিনিদ্র	বিনিদ্র
মালয়েশিয়ায়	মালয়েশিয়া
শিক্ষাব্যবস্থা	শিক্ষাব্যবস্থা
দৃষ্টিভঙ্গিগুলোকে	দৃষ্টিভঙ্গি
ব্রাউনের	ব্রাউন
লুডু	লুডু
স্কার্ট	স্কার্ট
ছেলেসহ	ছেলে
কীধরনের	কীধরন
ভরাডুবি	ভরাডুবি
লক্ষণীয়ভাবে	লক্ষণ
পরিষেবার	ষেবা
রতিহত	রতিহ
পদক্ষেপও	পদক্ষেপ
অংশের	অংশ
এরিক	এরিক
বার্তায়	বার্তা
শেষ	শেষ
তখনই	তখন
হোমো	হোমো
আফগানিস্তানে	আফগানিস্তান
সুমহান	মহান
নিশাম	নিশাম
ফরাসি	ফরাসি
বাঁচান	বাঁচা
বালুরঘাট	বালু
জিম্মি	জিম্মি
রুই	রুই
অ্যাক্টিভেটেড	অ্যাক্টিভেট
উদারভাবে	উদার
গলায়	গলা
সমুন্নত	সমুন্নত
লাশও	লাশ
উপাস্যের	উপাস্য
ফন্দি	ফন্দি
টুলটি	টুল
ইয়াসমিনের	ইয়াসমিন
উল্লেখযোগ্যভাবে	উল্লেখ
জিতেছে	জিত
সারবিয়ান	সারবিয়া
দামটা	দাম
ভূইঞা	ভূইঞা
উদ্ধারকর্তা	উদ্ধারকর্তা
নাইটিঙ্গেল	নাইটিঙ্গেল
ইউরোপীয়ান	ইউরোপীয়ান
রাজিন	রাজিন
ব্যাক্তিত্ব	ব্যাক্তি
শিখিয়েছি	শিখ
মোকাম্মেল	মোকাম্মেল
চার্জের	চার্জ
তিল	তিল
রেণুকা	রেণুকা
নোটগুলি	নোট
দূর্যোগ	দূর্যোগ
খায়	খায়
প্রাণরসায়নবিদ	প্রাণরসায়নবিদ
ক্যাসিনোতে	ক্যাসিনো
পথচারীকে	পথচারী
থানায়	থানা
আওয়ার	আওয়ার
কল্পিত	কল্প
কেনশিন	কেনশিন
পরিচয়	পরিচয়
ধানগাছ	ধান
মুক্তিযুদ্ধকালীন	মুক্তিযুদ্ধ
হোয়াইটের	হোয়াইট
রাজপ্রতিনিধি	রাজ
জাদুকরী	জাদু
ইন্দোনেশিয়ার	ইন্দোনেশিয়া
লাগলেন	লাগল
প্রণয়নের	প্রণয়ন
আজ্ঞাপালন	আজ্ঞাপালন
দেওয়াই	দেওয়া
অগাস্ট	অগাস্ট
লেবারের	লেবার
মিরান্ডা	মিরান্ডা
গর্ববোধ	গর্ব
মাষ্টার	মাষ্টার
মোকাবেলায়	মোকাবেলা
প্রস্তাবগুলি	প্রস্তাব
অঞ্চলভিত্তিক	অঞ্চল
বর্বর	বর্বর
চেয়ারটি	চেয়ার
দুর্নীতিবিরোধী	দুর্নীতি
গদির	গদি
রিচার্ডস	রিচার্ড
পাঠাভ্যাস	পাঠ
খারাপভাবে	খারাপ
ইকুইভ্যালেন্ট	ইকুইভ্যালেন্ট
নিব	নিব
লিখলেন	লিখল
বসালেন	বসা
পল্লবী	পল্লবী
ঝলকে	ঝলক
মাইলের	মাইল
ব্রডি	ব্রডি
চাকরিরত	চাকরি
বিষয়টিই	বিষয়
উচ্চকণ্ঠ	উচ্চ
আরাফাতকে	আরাফাত
ইন্টারনেটকে	ইন্টারনেট
জ্যানেট	জ্যানেট
মোটামুটিভাবে	মোটামুটি
করেননি	কর
রূপপুর	রূপপুর
নেটওয়ার্কের	নেটওয়ার্ক
কার্যকরভাবে	কার্য
ধরণেরই	ধরণ
মস্তকস্বরূপ	মস্তক
ভূমিকার	ভূমিকা
দেওয়ানী	দেওয়ান
এসকিউএল	এসকিউএল
অ্যাগার	অ্যাগার
স্নেহা	স্নেহ
ধেও	ধে
চড়	চড়
সম্রাজ্যবাদকে	সম্রাজ্য
সাথে	সাথে
হারাচ্ছেন	হার
লাগায়	লাগা
বাড়াচ্ছেন	বাড়াচ্ছে
ফিশন	ফিশন
বিশ্বনাথে	বিশ্বনাথ
কমাতে	কম
বসাতে	বসা
সাঁওতালি	সাঁওতাল
উপজেলাটি	উপজেলা
খিত	খিত
সামঞ্জস্য	সামঞ্জস্য
রাজবাড়িতে	রাজবাড়ি
চেক	চেক
যাপনে	যাপন
বৈদ্যুতিকভাবে	বৈদ্যুতিক
বিষপানে	বিষ
বৈরাগী	বৈরাগ
বীর্যপাত	বীর্য
মকবুল	কবুল
মোছা	মোছা
ডিপিপি	ডিপিপি
তাত্ক্ষণিক	তাত্ক্ষণিক
করেছো	করে
ম্যাকাফি	ম্যাকাফি
পরিদর্শনকারী	দর্শন
মঠবাড়িয়ার	মঠ
বসেছি	বস
মহিমান	মহিমান
ব্যবধান	ব্যবধান
কানে	কান
বোলপুর	বোলপুর
সাহারান	সাহারান
আন্দিজ	আন্দিজ
বাষ্পচালিত	বাষ্প
মিরাজের	মিরাজ
কমান্ডারদের	কমান্ডার
স্বৈরতন্ত্রের	স্বৈর
সাজাপ্রাপ্ত	সাজা
মনিজা	মনি
শেরশাহ	শেরশাহ
আচরণও	আচরণ
কালকে	কাল
যাত্রাপুর	যাত্রাপুর
উপহারটা	উপহার
অনুসারে	অনুসার
অনুমোদনে	অনুমোদন
খন্ডের	খন্ড
অভিমানী	অভিমান
লিনাক্সের	লিনাক্স
মাপের	মাপ
পূর্ণবর্গ	বর্গ
মুম্বইতে	মুম্বই
শীতাতপ	শীতাতপ
নিচতলা	নিচতলা
শোনাবেন	শোনা
যদান	যদা
ব্যাকফুটে	ফুট
গোলসংখ্যা	গোল
ঐক্যবদ্ধভাবে	ঐক্যবদ্ধ
শুভানুধ্যায়ীরা	শুভানুধ্যায়ী
স্ট্র্যাটেজি	স্ট্র্যাটেজি
পড়ন্ত	পড়ন্ত
দমকা	দমকা
ইন্টারেক্টিভ	ইন্টারেক্ট
দেওয়ানের	দেওয়ান
ঘোষনার	ঘোষনা
হৃৎপিন্ড	হৃৎপিন্ড
দেখাশুনা	দেখা
ষের	ষের
খামারে	খামার
ভিতালি	ভিতালি
অশ্বিনী	অশ্বিনী
বাক্যে	বাক্য
যুগকে	যুগ
কার্টুনের	কার্টুন
দ্রুততায়	দ্রুত
এমনটিই	এমন
মাঝবয়সী	মাঝ
স্বল্পদৈর্ঘ্য	স্বল্প
জলাঞ্জলি	জলাঞ্জলি
সম্বলিত	সম্বলিত
জল্লাদের	জল্লাদ
মারুফুল	মারুফুল
দেখায়নি	দেখায়
ডিসেম্বর	ডিসেম্বর
কালিকট	কালি
রোগতত্ত্ব	রোগ
গর্ভস্থ	গর্ভস্থ
সাঁকোর	সাঁকো
ধোঁয়াশা	ধোঁয়াশা
নিউমোনিয়ায়	নিউমোনিয়া
বাংলাদেশও	বাংলাদেশ
প্রতিরোধী	প্রতিরোধ
লিটারপ্রতি	লিটার
মারপিটের	মারপিট
রেবতী	রেবতী
তালা	তালা
দুটিতে	দুটি
আরোহনের	আরোহন
ফ্রাঙ্ক	ফ্রাঙ্ক
শিবসাগর	শিব
রেলক্রসিংয়ের	রেলক্রসিং
যারাই	যারা
বদমেজাজি	বদমেজাজ
বহিষ্কার	বহিষ্কার
শাম্মী	শাম্মী
মমতাজ	মমতাজ
উপস	উপস
বোঝাতেও	বোঝ
ব্লাস্টিং	ব্লাস্ট
আদর	আদর
ফ্লাড	ফ্লাড
খোলসে	খোলস
চুয়াডাঙ্গা	চুয়াডাঙ্গা
কৌশল	কৌশল
কর্তৃপক্ষ	পক্ষ
জমিদারের	জমিদার
বাগদাদির	বাগদাদ
তাপীকরণ	তাপীকরণ
সীমান্তসংলগ্ন	সীমান্ত
স্থলপথে	স্থলপথ
জাফরান	জাফর
পিকেটাররা	পিকেটার
থায়ী	থায়
পোশাকশ্রমিকেরা	শ্রমিক
যাচারীদের	যাচারী
শেলফে	শেলফ
অভিযোজন	যোজন
নীতিই	নীতি
গড়াবে	গড়া
সাক্ষিরা	সাক্ষি
লোকজনের	লোক
দাদের	দাদ
শ্রীলংকার	শ্রীলংকা
সভানেত্রী	সভা
কৃত্তিবাস	কৃত্তি
কমিশনাররা	কমিশনার
জিওগ্রাফি	জিওগ্রাফি
কৃষককে	কৃষক
জানালে	জানাল
কতককে	কত
বৃন্দাবনের	বন
মওদুদের	মওদুদ
ইসমাঈল	ইসমাঈল
ফ্র	ফ্র
রানাতুঙ্গা	রানাতুঙ্গা
ভ্রুক্ষেপ	ভ্রুক্ষেপ
জেনেলিয়া	জেনেলিয়া
গ্রন্থ	গ্রন্থ
তালেবানরা	তালেবান
স্যুইচ	স্যুইচ
সনাক্ত	সনাক্ত
জ্ঞানপীঠ	জ্ঞান
শয্যাশায়ী	শয্যাশায়ী
ফসিল	ফসিল
মোরগের	মোরগ
কোডার	কোড
বালিপাড়া	বালি
ফিজিকস	ফিজিকস
প্রসবের	প্রসব
শিক্ষাবর্ষে	শিক্ষা
সিদ্দিকীর	সিদ্দিকী
ওয়েসলি	ওয়েসলি
ক্যাটাগরির	ক্যাটাগরি
গণশুনানিতে	শুনানি
অনেকাংশে	অনেক
মুঠোফোনে	ফোন
সংগঠকরা	সংগঠক
পরমদেশের	পরমদেশ
দালাল	দালাল
গুণী	গুণ
মোনাকোর	মোনা
ব্যাটসম্যানও	ব্যাটসম্যান
প্যারাগুয়ে	প্যারাগুয়ে
প্রভাবগুলি	প্রভাব
মোসাক	মোসাক
জন্মনিবন্ধন	জন্মনিবন্ধন
বসতির	বসত
প্রতিধ্বনিত	ধ্বনি
আখড়ার	আখড়া
ছায়াছবি	ছায়া
নোকিয়া	নোকিয়া
কোণার	কোণা
অপেক্ষাতেই	অপেক্ষা
ডাউ	ডাউ
বাটির	বাটি
বালাইনাশক	বালাইনাশক
ক্ষমতাসীন	ক্ষমতা
এসএনসি	এসএনসি
অনুসারীগণ	অনুসারী
ক্লোজ	ক্লোজ
নেভানোর	নেভান
হাপর	হাপর
সুবিধাগুলো	সুবিধা
প্রথায়	প্রথা
ভারতেই	ভারত
আইপিটিভি	আইপিটিভি
মোহামেডানের	মোহামেডান
মিসকীন	মিসকীন
ড্রেন	ড্রেন
ব্যাসিল	ব্যাসিল
রেজাকে	রেজা
অর্ধদিবস	অর্ধদিবস
সমতট	সমতট
সামাজিকভাবে	সামাজিক
অর্ডিনারি	অর্ডিনারি
বিষোদ্গার	বিষোদ্
চারে	চার
সীমালংঘনকারী	সীমালংঘন
আলমারির	আলমারি
অ্যাডমিনিস্ট্রেশন	অ্যাডমিনিস্ট্রেশন
সম্মেলনগুলোতে	সম্মেলন
শাবনূরের	শাবনূর
ভিজ্যুয়াল	ভিজ্যুয়াল
মাইনুল	মাইনুল
অভিযোগটা	অভিযোগ
ঘাড়	ঘাড়
বাকেরগঞ্জ	বাকেরগঞ্জ
পাখিটি	পাখি
ট্রাস্ট	ট্রাস্ট
আরোহণ	আরোহণ
ট্রট	ট্রট
রামেন	রামেন
তোমরাই	তোমরা
গীতিকবিতা	গীতিকবিতা
রুহানির	রুহ
বর্ষায়	বর্ষা
কালিহাতী	কালিহাতী
তৈরিতে	তৈরি
বিষয়	বিষয়
ডিভিশনের	ডিভিশন
জর্দা	জর্দা
গুরুত্ত্ব	গুরুত্ত্ব
মনোভাবও	মনোভাব
চারা	চার
ট্রলিতে	ট্রলি
আলোকসজ্জা	আলো
মহাকাশমন	মহা
পেটের	পেট
পুরষ্কারের	পুরষ্কার
জিউসের	জিউস
নৃত্যের	নৃত্য
মোহনবাগানের	বাগান
আপনাদিগকে	আপনাদিগ
সাহিত্যাদি	সাহিত্য
শাকিলকে	শাকিল
কিটক্যাট	কিটক্যাট
নীতিসমূহ	নীতি
চারপাশের	পাশ
হিজড়ারা	হিজড়া
গোষ্ঠীগত	গোষ্ঠী
ইউরেনিয়াম	ইউরেনিয়াম
অপারেটরদের	অপারেট
অংশগুলিকে	অংশ
মহীনের	মহীন
ক্রমহ্রাসমান	ক্রমহ্রাস
হর্টন	হর্টন
বাক্যবিনিময়	বাক্যবিনিময়
ধাঁধায়	ধাঁধা
সাপোর্টে	সাপোর্ট
ম্যাগনেটিক	ম্যাগনেট
নুরুদ্দিন	নুরুদ্দিন
ম্যাথ	ম্যাথ
বাতিটি	বাতি
ফিরহাদ	ফিরহাদ
টিএমএসএস	টিএমএসএস
মাহিন	মাহিন
ব্যবস্থাপককে	ব্যবস্থা
কাশীর	কাশী
অল্পবয়সিদের	বয়স
আস্থাহীনতা	আস্থা
কাসেম	কাসেম
মালায়ালম	মালায়ালম
কামলা	কামলা
রজার্স	রজার্স
আইয়াজ	আইয়াজ
পায়ে	পায়
পশু	পশু
জুয়া	জুয়া
এনামুলের	এনামুল
সন্নিহিত	সন্নিহিত
পরিচিতিতে	পরিচিত
বোঝাচ্ছেন	বোঝাচ্ছে
কৃষ্ণপক্ষ	কৃষ্ণ
চোখধাঁধানো	চোখ
লোকো	লোক
কম্পাঙ্কনির্ভর	কম্পাঙ্ক
দারুস	দারুস
ঝোপঝাড়ের	ঝোপ
পরিচালকগোষ্ঠীর	পরিচালক
লোয়ার	লোয়ার
কখনোই	কখন
সহচর	সহচর
শুনানিতে	শুনানি
ভুলকে	ভুল
আরাফাতের	আরাফাত
বিশ্বকাপেও	বিশ্বকাপ
অপুষ্টিজনিত	অপুষ্টি
জেটির	জেটি
ডিজাইনকৃত	ডিজাইন
শীলা	শীলা
মহাবিশ্বের	মহাবিশ্ব
অন্ধভাবে	অন্ধ
নিংবো	নিংবো
ইন্দোর	ইন্দোর
নিসাব	নিসাব
চাকুরিতে	চাকুরি
চরমানন্দ	চরমানন্দ
প্রেসিডিয়াম	প্রেসিডিয়াম
পরীক্ষাই	পরীক্ষা
চুপকে	চুপ
পাচারকারীদের	পাচারকারী
নিয়ন্ত্রণের	নিয়ন্ত্রণ
সারিবদ্ধ	সারি
ইউএনএস	ইউএনএস
এপির	এপি
আউটসোর্সিংয়ের	আউটসোর্সিং
নাম্	নাম
যেন	যেন
কিয়ার্শ	কিয়ার
আসরের	আসর
ক্রিকেটকে	ক্রিকেট
করেছিলে	কর
ক্যান্টারবারি	ক্যান্টারবারি
পুনর্জীবিত	পুনর্জীব
ঐক্যমত্য	ঐক্য
কিয়েভ	কিয়েভ
সঙ্গমস্থলে	সঙ্গমস্থল
আর্থ	আর্থ
ক্যাথেড্রালের	ক্যাথেড্রাল
অবতীর্ণ	তীর্ণ
রঘুনাথপুর	রঘুনাথপুর
সমাজব্যবস্থা	সমাজ
স্কোপ	স্কোপ
স্ট্রীটের	স্ট্রীট
লুব্রিকেশন	লুব্রিকেশন
নামবিহীন	নাম
থাকেনি	থাক
নির্মানাধীন	নির্মান
প্রতিজ্ঞার	প্রতিজ্ঞা
ঝড়টা	ঝড়
জেনারেলদের	জেনারেল
বেচাকেনা	বেচা
বলটিকে	বল
গোর্খাল্যান্ড	গোর্খাল্যান্ড
ইন্দিরার	ইন্দিরা
ঢাকায়	ঢাকা
মোনাকো	মোনাকো
মন্তব্যের	মন্তব্য
ভোলেন	ভোল
সোবহানের	সোবহান
ধূর্ত	ধূর্ত
জনগনকে	জনগন
জ্যোতির্বিজ্ঞানীরা	জ্যোতির্বিজ্ঞান
হাজি	হাজি
স্বেচ্ছাচারিতার	স্বেচ্ছা
গজানো	গজ
জন্মস্থান	জন্মস্থান
অনুযায়ি	অনুযায়
প্রবেশকারী	প্রবেশ
তাতিয়ে	তাত
কাঁচের	কাঁচ
ইস্হাকের	ইস্হাক
খড়ি	খড়ি
স্থায়ীরূপে	স্থায়ী
বণিকদের	বণিক
কারুকাজ	কারু
মিলারের	মিলার
মসজিদটিতে	মসজিদ
পড়বার	পড়
ক্ষতিকর	ক্ষতি
ট্রেসি	ট্রেসি
বেলচা	বেলচা
হারাবে	হারা
গোদ	গোদ
বিতার্কিক	বিতার্কিক
পতাকাটি	পতাকা
দিব্যি	দিব্যি
রসূলগণ	রসূল
ধীরলয়ে	ধীর
নিবন্ধগুলির	নিবন্ধ
ম্যালা	ম্যালা
কৃতিত্বের	কৃতিত্ব
হালুয়া	হালুয়া
মগজের	মগজ
সাফল্য	সাফল্য
আকাশী	আকাশ
ফ্রিল্যান্স	ফ্রিল্যান্স
খালিদ	খালিদ
নিদর্শনগুলো	নিদর্শন
ফার্গুসনের	ফার্গু
অ্যালার্ম	অ্যালার্ম
এলেঙ্গা	এলেঙ্গা
মোটরওয়ে	মোটরওয়ে
পরিসংখ্যানটি	পরিসংখ্যান
ওয়াটার	ওয়াটার
মূমিনদের	মূমিন
মোড়	মোড়
কুর্দিদের	কুর্দি
ইউনূস	ইউনূস
রক্ষণাবেক্ষণ	রক্ষণ
সেন্টার	সেন্টার
প্রতিবিধান	প্রতিবিধান
একতাবদ্ধভাবে	একতা
কেনার	কেন
মোবারকের	মোবারক
আজাইরা	আজাইরা
ভেতরও	ভেতর
অভিপ্রায়	অভিপ্রায়
লাইফের	লাইফ
ফার্মগেট	ফার্মগেট
দ্যাট	দ্যাট
কার্যকারীতা	কার্য
সিংহাসনচ্যুত	সিংহ
টাকাটা	টাকা
নীতিবোধ	নীতি
লালনপালনের	লালনপালন
ক্রীড়ার	ক্রীড়া
মেনেও	মেনে
বিএমডাব্লু	বিএমডাব্লু
ত্রিশের	ত্রিশ
বসবাস	বাস
মোস্তাফা	মোস্তাফা
উদ্ভাবক	উদ্ভাবক
অধ্যায়ভিত্তিক	অধ্যায়
নিয়মও	নিয়ম
কোন্দলের	কোন্দল
তাইওয়ানে	তাইওয়ান
রেপ	রেপ
দীঘিনালা	দীঘি
জায়েদ	জায়েদ
রৌপ্যের	রৌপ্য
খোলা	খোল
নাপিত	নাপিত
বসিরহাট	বসিরহাট
একজনই	একজন
ছাড়াও	ছাড়া
লক্ষ্মীপুর	লক্ষ্মীপুর
আর্সেনাল	আর্সেনাল
গনি	গনি
মরীচিকা	মরীচিকা
মহেশখালীর	মহেশখালী
স্প্রকেট	স্প্রকেট
নেদারল্যান্ড	নেদারল্যান্ড
বয়ের	বয়
গর্ভাশয়	গর্ভাশয়
বলিল	বল
সিগমা	সিগমা
এটার	এটা
ফিলি	ফিল
জড়িয়েছে	জড়িয়ে
যেজন	জন
ছুলা	ছুলা
প্রাণপ্রিয়	প্রিয়
হিমাংশু	হিমাংশু
টেনের	টেন
চেখভ	চেখভ
বারাক	বারাক
আত্বপ্রকাশকারী	প্রকাশ
অভিমুখ	মুখ
অগ্রভাগে	অগ্রভাগ
বাচসাস	বাচসাস
সৈয়দপুর	সৈয়দপুর
লিপিবদ	লিপি
দৃষ্টান্ত	দৃষ্ট
তালার	তালা
পরিমণ্ডল	পরিমণ্ডল
ঢুকেছে	ঢুকে
টেলিগ্রাম	টেলিগ্রাম
এতটা	এত
ফিজিক্সের	ফিজিক্স
গ্রামবাসী	গ্রাম
শোনাল	শোন
সমমর্যাদার	মর্যাদা
এসেছি	এস
ছোড়ার	ছোড়া
দিলশাদ	দিলশাদ
হৃৎপিণ্ড	হৃৎপিণ্ড
জঙ্গিপুর	জঙ্গিপুর
সাইটটি	সাইট
প্রাচীনকালের	প্রাচীনকাল
স্ট্যাকার	স্ট্যাক
ভিসি	ভিসি
দ্বীনী	দ্বীন
কর্মদক্ষতা	কর্ম
বটেই	বটে
তলোয়ারের	তলোয়ার
স্বাদের	স্বাদ
পালনকালে	পালন
ড্যান্সার	ড্যান্স
ফৌজদারি	ফৌজদার
আয়করের	কর
স্কুলস	স্কুল
বসছেন	বসছে
সবগুলোতেই	সব
চেতনার	চেতনা
পূর্বেই	পূর্ব
জেরার্ড	জেরার্ড
ক্ষয়প্রাপ্ত	ক্ষয়
মুহ্যমান	মুহ্যমান
কেন্দ্রটির	কেন্দ্র
বিএসএফকে	বিএসএফ
পরিবর্তিত	পরিবর্ত
পরিত্যাগের	পরিত্যাগ
নিউইয়র্কে	নিউইয়র্ক
এমএলএম	এমএলএম
আড়াআড়িভাবে	আড়াআড়িভাবে
ব্যবস্থাগুলো	ব্যবস্থা
মোটে	মোট
অসম্ভবকে	সম্ভব
সাঁতারু	সাঁতার
টুলিং	টুলি
মাস্তুল	মাস্তুল
গঙ্গাচড়া	গঙ্গাচড়া
অত্যাধুনিক	অত্যাধুনিক
ওয়ারিস	ওয়ারিস
দেখিয়েছে	দেখ
সহিদুল	সহিদুল
ছত্রভঙ্গ	ছত্র
রিফ্লেক্স	রিফ্লেক্স
জেরি	জেরি
শাই	শাই
বঞ্চিতদের	বঞ্চিত
ইরান	ইরান
নাওয়াজ	ওয়াজ
ডবল	ডবল
একরকম	এক
উম্মত	উম্মত
ষোলো	ষোলো
দাঁড়ানোয়	দাঁড়ান
ত্যক্ত	ত্যক্ত
পরিসর	পরিসর
টাটার	টাটা
উপাংশ	উপাংশ
আয়ুষ্কাল	আয়ু
সৈকতরেখা	সৈকত
রকিং	রকি
প্রত্যাখ্যান	প্রত্যাখ্যান
অধ্যাপকেরা	অধ্যাপক
পালটে	পালট
খণ্ডে	খণ্ড
সাহিদ	সাহিদ
ডিভিশনে	ডিভিশন
ডমিনিক	ডমিনিক
সহউপাসকদের	সহউপাসক
ব্যবস্থা	ব্যবস্থা
শর্তযুক্ত	শর্ত
প্রশংসার	প্রশংসা
জিন	জিন
সারাক্ষণই	সারাক্ষণ
পরোক্ষভাবে	পরোক্ষ
চুল্লির	চুল্লি
লেখচিত্রের	লেখচিত্র
পলিসি	পলিসি
ঞাপন	ঞাপন
আগাছার	গাছ
উরুর	উরু
উপমহাপরিদর্শক	পরিদর্শক
রাজ্য	রাজ্য
মূত্রের	মূত্র
মালয়েশিয়াকে	মালয়েশিয়া
সতর্কবার্তা	সতর্কবার্তা
স্মৃতিচারণা	স্মৃতিচারণ
ওঠা	ওঠ
খননকারীর	খনন
এনসিআর	এনসিআর
পুঁজিবাজারে	পুঁজিবাজার
ভঙ্গীতে	ভঙ্গী
শ্রেয়তর	শ্রেয়
সম্রাটের	সম্রাট
স্নোডেনের	স্নোডেন
শিকে	শিক
দায়ান	দায়ান
আসিনি	আসিনি
আর্মেনিয়ান	আর্মেনিয়া
পরিপূর্ণরূপে	পূর্ণরূপ
হাবিবে	হাবিব
মেঘের	মেঘ
এলাকাবাসীর	এলাকা
জাদুঘরের	জাদুঘর
টর্চার	টর্চার
নেপলস	নেপল
কুতিনহোকে	কুতিনহোক
ত্রিপিটক	ত্রিপিটক
মহাদেশীয়	দেশ
ভুলতা	ভুল
দিদারুল	দিদারুল
শুনবো	শুনব
নিয়াজী	নিয়াজী
প্রথাগতভাবে	প্রথাগত
বাত্রা	বাত্রা
হটানোর	হটানো
দেবেন্দ্র	দেবেন্দ্র
দুজনেই	দু
ঘায়েল	ঘা
প্রয়োজনীয়তার	প্রয়োজন
সুবিধাগুলির	সুবিধা
হেমন্তের	হেমন্ত
জিনিসটার	জিনিস
থাকিলে	থাক
লেন্সে	লেন্স
চেষ্টায়	চেষ্টা
হাইটস	হাইট
মন্ত্রণালয়ের	মন্ত্র
মানালি	মানালি
বিটিএমএর	বিটিএম
এরিস	এরিস
পরতে	পর
নফস	নফস
মাধ্যমগুলো	মাধ্যম
নফল	নফল
চিত্ত	চিত্ত
এসএসডি	এসএসডি
মেরিল	মেরিল
গরমমসলা	গরম
পিটার্স	পিটার্স
আলীকদম	আলীকদম
ওসিসহ	ওসি
রেক	রেক
মানসম্পন্ন	মান
ডিডিএস	ডিডিএস
সিলিন্ডার	সিলিন্ডার
পঞ্চাশত্তমীর	পঞ্চাশত্তমী
কানকে	কান
আশাক	আশাক
স্বরধ্বনির	স্বর
মস্তক	মস্তক
গাড়িতে	গাড়ি
বধ্যভূমি	বধ্যভূমি
সমিতির	সমিতি
বিতর	বিতর
কাকদ্বীপ	দ্বীপ
নবী	নবী
সওয়ার	সওয়ার
নাইজেরিয়ায়	নাইজেরিয়া
চট্টগ্রামবাসীর	চট্টগ্রামবাসী
মহানগরের	মহানগর
ইউসিবির	ইউসিবি
এ্যাপার্টমেন্টের	এ্যাপার্টমেন্ট
চ্যাপম্যানের	চ্যাপম্যান
চেকআপ	চেক
স্যার	স্যার
স্পেক	স্পেক
কর্মব্যস্ততা	কর্ম
সাইকোলজিস্ট	সাইকোলজি
আনুষ্ঠানিক	আনুষ্ঠান
বিবর্তনবাদ	বিবর্তন
ক্রীটে	ক্রীট
হারালেও	হার
পিচ	পিচ
পাচক	পাচক
মহাপুরুষ	পুরুষ
নিউজপেপার	নিউজপেপার
ইন্টিগ্রাল	ইন্টিগ্রাল
যোগব্যায়ামের	ব্যায়াম
অতিরঞ্জন	রঞ্জন
মেশিনটা	মেশিন
প্যাকে	প্যাক
রাজান	রাজান
এডিবি	এডিবি
জায়েদ	জায়েদ
শস্যদানা	শস্য
কনসোর্টিয়াম	কনসোর্টিয়াম
অন্ত্যেষ্টিক্রিয়ায়	অন্ত্যেষ্টিক্রিয়া
কৃষকের	কৃষক
রাস্তাটির	রাস্তা
তুলসী	তুলসী
সাইট্রিক	সাইট্রিক
তেলসমৃদ্ধ	তেল
মেহেরপুরের	মেহেরপুর
নিয়েছেন	নিয়েছ
উদ্দীনকে	উদ্দীন
ভাসানীর	ভাসানী
কায়া	কায়া
বিভিন্নরকম	বিভিন্ন
বোলারই	বোলার
কারাভোগের	কারাভোগ
মিত্রদের	মিত্র
বিকিরিত	বিকিরিত
রতিটি	রতি
ভিত	ভিত
কাভানি	কাভানি
আলাউদ্দিন	আলাউদ্দিন
পরিষেবাগুলি	পরিষেবা
সম্বন্ধযুক্ত	সম্বন্ধ
সাঁকোটি	সাঁকো
এলিয়টের	এলিয়ট
সহমর্মী	সহমর্মী
সিফাতের	সিফাত
ট্রফিতে	ট্রফি
হানিফের	হানিফ
ঐশ্বরিক	ঐশ্বরিক
পিসের	পিস
আসরে	আসর
লিংকের	লিংক
সংঘর্ষ	সংঘর্ষ
ফুটবলার	ফুটবল
সালভাদরে	সালভাদর
বিজ্ঞানবিষয়ক	বিজ্ঞান
দমনপীড়ন	দমন
কার্জনের	কার্জন
বারোটা	বারো
সেনাপ্রধানের	সেনাপ্রধান
কবিতাকে	কবিতা
অনন্তকালের	অনন্ত
রদায়	রদ
সমন্বয়হীনতা	সমন্বয়
ক্যালসিয়াম	ক্যালসিয়াম
আরবের	আরব
প্রতিরূপ	প্রতিরূপ
আসনেই	আসন
কেল্লার	কেল্লা
থিমটি	থিম
শিমুলিয়া	শিমুল
বিচ্ছিন্নতাবাদীদের	বিচ্ছিন্নতা
কাহারও	কাহার
চাষের	চাষ
ওয়েবসাইট	ওয়েবসাইট
সুপ্রসিদ্ধ	প্রসিদ্ধ
অনুরোধের	অনুরোধ
সরবরাহকৃত	সরবরাহ
ভাইজান	ভাই
ইসলামাবাদ	ইসলামাবাদ
অদ্বিতীয়	দ্বিতীয়
জসীমউদ্	জসীম
স্থাপনসহ	স্থাপন
স্বাক্ষরিত	স্বাক্ষর
নির্বিঘ্নে	নির্বিঘ্ন
লর্ডসের	লর্ডস
ডংগুয়ান	ডংগুয়ান
মামলাকে	মামলা
ঝিনাইদহ	ঝিনাইদহ
কাণ্ডজ্ঞান	কাণ্ডজ্ঞান
মরণোত্তর	মরণোত্তর
এনেছেন	এনেছ
পুনঃপ্রতিষ্ঠার	প্রতিষ্ঠা
লালা	লালা
বলছিনা	বল
হাজারীবাগ	হাজারীবাগ
স্ক্রিনে	স্ক্রিন
দাওয়া	দাওয়া
বসুকে	বসু
গোল	গোল
ঐতিহ্যবাহী	ঐতিহ্য
জুগিয়েছিলেন	জুগিয়ে
সৌজন্যবোধ	সৌজন্য
কোয়ালিটির	কোয়ালিটি
কারণগুলোর	কারণ
কেল্লা	কেল্লা
জায়গায়ও	জায়গায়
সম্মেলনে	সম্মেলন
জনকেই	জন
শাস্ত্রের	শাস্ত্র
চৌদ্দগ্রামের	চৌদ্দ
তক্ষুনি	তক্ষুনি
শিওর	শিওর
ঢাকাবাসীর	ঢাকা
সদলবলে	সদলবল
হত্যাকে	হত্যা
ঘোষণায়	ঘোষণা
হাফিজিয়া	হাফিজিয়া
রুনা	রুনা
ম্যাক	ম্যাক
তাজমহল	তাজমহল
এমজি	এমজি
এলাকাবাসীকে	এলাকা
ধর্মপাল	ধর্মপাল
সন্দিহান	সন্দিহান
মিরাজুল	মিরাজুল
ভাইবোনকে	ভাইবোন
নূরের	নূর
নিরাময়ের	নিরাময়
জেটলি	জেট
পর্যটক	পর্যটক
শালার	শালা
শাসক	শাসক
কন্যারা	কন্যা
রমণীর	রমণী
জাফরুল্লাহ	জাফরুল্লাহ
অর্থকে	অর্থ
অন্তরকে	অন্তর
বাণিজ্যকেন্দ্র	বাণিজ্য
বোটানিকাল	বোটানি
উদাত্ত	উদাত্ত
ট্রেডার্স	ট্রেডার্স
আয়োজনের	আয়োজন
জীবাণুমুক্ত	জীবাণু
পিটিশনের	পিটিশন
ত্রাণমন্ত্রী	ত্রাণ
বাহাদুরাবাদ	বাহাদুরাবাদ
ভাইসরয়ের	ভাইসর
লুকোনো	লুকোন
পরীক	পর
সংকটও	সংকট
গিরিশ	গিরিশ
ব্যারাকের	ব্যারাক
যিহুদিরা	যিহুদি
ডিনারে	ডিনার
বহির্গমন	বহির্গমন
চেষ্ঠা	চেষ্ঠা
জোয়ারভাটা	জোয়ার
মর্যাদার	মর্যাদা
ছেলেমেয়েদের	ছেলে
নয়াপল্টনের	পল্টন
রেগুলেটর	রেগুলেট
স্ক্যান	স্ক্যান
মূল্যরূপ	মূল্য
ইতঃপূর্বে	ইতঃপূর্ব
আবুধাবির	আবুধাবি
মহারাজ	মহারাজ
বিফ	বিফ
জলরং	রং
রূপকথার	রূপকথা
গ্রন্থপ্রাপ্ত	গ্রন্থপ্রাপ্ত
যানজটও	যান
অস্ত্রধারীদের	অস্ত্রধারী
শ্যামলী	শ্যামলী
ফুফুর	ফুফু
স্বরূপ	রূপ
ফলাতে	ফলা
শিপইয়ার্ডে	শিপইয়ার্ড
ছার	ছার
অ্যাক্রিডিটেশন	অ্যাক্রিডিটেশন
স্কেটবোর্ড	স্কেটবোর্ড
খুন্তি	খুন্তি
আজমেরী	আজমেরী
পাশে	পাশ
কদিনে	দিন
আমানউল্লাহ	আমানউল্লাহ
নৈহাটি	নৈহাটি
মধ্যবয়স্ক	মধ্যবয়স্ক
যোগাযোগমাধ্যমের	যোগাযোগমাধ্যম
সালেক	সালেক
নাকচ	নাকচ
নিয়মিত	নিয়ম
বরজ	বরজ
জৈন্তাপুর	জৈন্তাপুর
মঙ্গলকোট	মঙ্গলকোট
অবুঝ	অবুঝ
ক্রমবিন্যাস	ক্রম
মার্গের	মার্গ
সুনিশ্চিত	নিশ্চিত
ঠান্ডায়	ঠান্ডা
ম্যার্কেলের	ম্যার্কেল
ইনডিকেটর	ইনডিকেটর
উষ্ণতম	উষ্ণ
ভূপৃষ্ঠে	ভূপৃষ্ঠ
ক্যামেরা	ক্যামেরা
কতটুকুই	কতটুকু
বিক্রয়ের	বিক্রয়
পাইলিং	পাইলিং
জয়েস	জয়
মানদন্ড	মান
আফাজ	আফাজ
এপিএস	এপিএস
লাখাই	লাখাই
কিং	কিং
বাণিজ্যসচিব	বাণিজ্যসচিব
প্লেক	প্লেক
করাইয়া	করাইয়া
যন্ত্রটির	যন্ত্র
ভাষণকে	ভাষণ
সন্দেহাতীতভাবে	সন্দেহ
ডুয়েল	ডুয়েল
নুসরাত	নুসরাত
কিচেন	কিচেন
দরের	দর
রেড্ডি	রেড্ডি
বিন্দুতে	বিন্দু
ছোটদের	ছোট
কিনারায়	কিনার
পিঠের	পিঠ
শ্যুট	শ্যুট
সরলরৈখিক	রৈখিক
কারাগার	কারাগার
অর্থসচিব	অর্থসচিব
স্বার্থক	স্বার্থক
শর্মার	শর্মা
জ্যামিতিতে	জ্যামিতি
নিয়োগ	নিয়োগ
ছেড়েছিলেন	ছেড়ে
বর্নের	বর্ন
চব্বিশ	চব্বিশ
গৌরী	গৌরী
মিজানুরকে	মিজানুর
হাটে	হাট
শ্রমশক্তি	শ্রমশক্তি
টাওয়ারের	টাওয়ার
পাজামা	পাজামা
যবনিকা	যবনিকা
অকেজো	কেজো
অখাদ্য	খাদ্য
প্রস্তাবও	প্রস্তাব
বারও	বার
তাহলো	তাহল
তরফ	তরফ
নৃতত্ত্ব	নৃতত্ত্ব
যেসমস্ত	সমস্ত
আকারেও	আকার
সময়ে	সময়
ককেশাসের	ককেশাস
মাইক্রোসফটে	মাইক্রোসফট
পানপাত	পানপাত
ভার্জিনিয়ার	ভার্জিনিয়া
চিন্তায়	চিন্তা
আরিয়েন	আরিয়েন
কৃষ্ণচন্দ্র	কৃষ্ণচন্দ্র
শিশি	শিশি
বেপারী	বেপার
তদ্রূপ	তদ্রূপ
পরিবারগুলোর	পরিবার
লিফলেট	লিফলেট
মাঝমাঠ	মাঠ
চিরকুটে	চিরকুট
প্রান্তিকে	প্রান্তিক
ভাবাপন্ন	ভাব
কলেজেই	কলেজ
মার্বেল	মার্বেল
ফিলিস্তিনের	ফিলিস্তিন
ওয়ানডের	ওয়ানডে
বিলেট	বিলেট
ইজিবাইকের	বাইক
পদধারী	পদধারী
উৎসুক	উৎসুক
দেড়টায়	দেড়
সমর্থনে	সমর্থন
স্ল্যাশ	স্ল্যাশ
রামপ্রসাদ	রামপ্রসাদ
যত্সামান্য	যত্সামান্য
বিশ্বযুদ্ধকালীন	বিশ্ব
স্পিলবার্গ	স্পিলবার্গ
ধীরগতি	ধীরগতি
ধর্মঘটে	ধর্মঘট
সহজ	সহজ
রংধনুর	রংধনু
জঙ্গিবাদ	জঙ্গি
পক্ষপাতদুষ্ট	পক্ষপাত
বিবর্তনবাদের	বিবর্তন
ভূখণ্ড	ভূখণ্ড
দিনক্ষণ	দিনক্ষণ
তালিকায়	তালিকা
টাস্কফোর্স	টাস্কফোর্স
ফরমানের	ফরমান
উপরেই	উপর
এসইজেড	এসইজেড
শেষকৃত্যে	শেষ
রেখেছিল	রেখ
অপকর্মে	কর্ম
ড্রায়ার	ড্রায়ার
শরণার্থীদের	শরণ
পথঘাট	পথ
ট্রাঙ্কলাইন	ট্রাঙ্কলাইন
সোনারগাঁওয়ে	সোনা
অসচেতন	অসচেতন
ব্যক্তিশ্রেণির	ব্যক্তি
ধৈর্যশীল	ধৈর্য
দিঘল	দিঘল
চেয়ার্স	চেয়ার্
তাপকে	তাপ
খোঁজও	খোঁজ
ক্রিপ্টোগ্রাফিক	ক্রিপ্টোগ্রাফিক
জ্যাকলিন	জ্যাকলিন
অরুন্ধতী	অরুন্ধতী
ফেরদাউস	ফেরদাউস
খলিল	খলিল
জমায়েত	জমায়েত
লুঙ্গি	লুঙ্গি
সাইজের	সাইজ
ইদ্রিসের	ইদ্রিস
মূর্খের	মূর্খ
পলিমারেজ	পলিমার
ডুমিনি	ডুমিনি
পোর্শ	পোর্শ
দশকগুলোতে	দশক
সংস্কৃতিসচিব	সংস্কৃতি
বিনিমেয়	বিনিমেয়
রানারআপ	রানারআপ
লোভ	লোভ
কমিশনকে	কমিশন
জ্যোতির্ময়	জ্যোতি
রিকোতে	রিকো
গম্বুজটি	গম্বুজ
পয়েন্টে	পয়েন্ট
সিকদারের	সিকদার
ওয়াশিংটনের	ওয়াশিংটন
উলের	উল
পাওলি	পাওলি
আমাকেই	আমাকে
স্পিন্ডল	স্পিন্ডল
পুঁজিবাদের	পুঁজিবাদ
বিড়ালের	বিড়াল
ক্রিড়া	ক্রিড়া
নতুনপাড়া	নতুন
পাঁচজনকে	পাঁচ
পরি	পরি
সেগুলির	সেগুলি
স্বাস্থ্যসচিব	স্বাস্থ্য
বিলাসিতার	বিলাসিতা
ট্রাস	ট্রাস
পরিশ্রমী	পরিশ্রম
মার্জ	মার্জ
ভাষাতেও	ভাষা
গন্য	গন্য
উদ্দেশ্যগুলি	উদ্দেশ্য
গবেষণাকে	গবেষণা
ধরবো	ধর
পরাবাস্তব	বাস্তব
করতেও	কর
উৎসমুখে	উৎস
এখনো	এখন
পৌষের	পৌষ
খায়া	খায়া
নাগরিকত্বের	নাগরিকত্ব
রায়ও	রায়
জ্যান্ত	জ্যান্ত
বেসিক	বেসিক
ডার্লিং	ডার্লিং
স্টেফানি	স্টেফানি
তওরাতে	তওরাত
চিকিৎসক	চিকিৎসক
রবীন্দ্রসংগীতের	সংগীত
খাইয়া	খাই
সাল	সাল
করাকালীন	করা
রোকন	রোকন
গণশিক্ষা	গণশিক্ষা
প্রাণহানি	প্রাণ
জোবাইদা	জোবাইদা
উল্লার	উল্লা
সবাইকেই	সবাই
এন্টিবায়োটিক	এন্টিবায়োটিক
ননদ	ননদ
দুইয়ে	দুই
ভাষাবিজ্ঞানের	ভাষাবিজ্ঞান
যোধপুরের	যোধপুর
অশ্বারোহীদের	অশ্বারোহী
মোল্লার	মোল্লা
দেখলেন	দেখ
ইন্দ্রিয়	ইন্দ্রিয়
যথাক্রমে	যথাক্রম
আকিকা	আকিকা
আসবেই	আস
বিমুখতা	বিমুখ
চোখের	চোখ
কাব্যগ্রন্থটি	কাব্য
ব্লুহোস্টের	ব্লুহোস্ট
রোলার	রোলার
বিধিমালায়	বিধিমালা
নেইমারের	নেইমার
ঢুকতে	ঢুক
মালিক	মালিক
রাক্ষসী	রাক্ষস
কক্ষপথের	কক্ষ
অ্যাক্টিভিং	অ্যাক্টিভ
ছিত	ছিত
অ্যাকটিভ	অ্যাকটিভ
আইনপ্রণেতা	আইন
আইডিএফ	আইডিএফ
সুন্দরীদের	সুন্দরী
রিয়াল	রিয়াল
চৌবাচ্চা	চৌবাচ্চা
স্থাপনকারী	স্থাপন
বেড়েছে	বেড়ে
ভ্যালিতে	ভ্যালি
মমিনুল	মমিনুল
ফেনীর	ফেনী
ডিআইপি	ডিআইপি
বিক্রয়	ক্রয়
বাঞ্ছনীয়	বাঞ্ছনীয়
মধ্যাহ্নভোজে	মধ্যাহ্নভোজ
ঝরা	ঝরা
বরাদ্দকৃত	বরাদ্দ
পাকিস্তানেও	পাকিস্তান
যুদ্ধক্ষেত্র	যুদ্ধক্ষেত্র
মনোনয়নের	মনোনয়ন
ভাঙন	ভাঙন
ইঙ্গিতও	ইঙ্গিত
আর্ম	আর্ম
নিরপেক্ষতার	নিরপেক্ষ
ট্রিপস	ট্রিপ
প্রয়োজনীয়তা	প্রয়োজন
শিরশ্ছেদ	শিরশ্ছেদ
তখনকার	তখন
হয়ছে	হয়
অনাহারে	অনাহার
তানজানিয়ার	তানজানিয়া
জেলও	জেল
আধিকারিক	আধিকার
যাওনি	যাওনি
শিল্পমন্ত্রী	শিল্পমন্ত্রী
সৎমা	মা
স্বাগতিকেরা	স্বাগতিক
তদারকির	তদারকি
দ্রব্যমূল্যের	দ্রব্যমূল্য
ডাটা	ডাটা
চরিত্রগুলোর	চরিত্র
লিমনের	লিমন
সম্প্রচার	সম্প্রচার
প্রেসে	প্রেস
সন্ত্রাসীরা	সন্ত্রাসী
রাজধানী	রাজ
গর্ত	গর্ত
লঙ্কার	লঙ্কা
যেগুলো	যে
ইউনিয়নে	ইউনিয়ন
রিটের	রিট
ভারতীর	ভারত
কুচ	কুচ
সাকুরা	সাকুরা
গণ্ডির	গণ্ডি
টুর্নামেন্টেই	টুর্নামেন্ট
মমর	মম
ব্রণ	ব্রণ
ফিটনেসবিহীন	ফিটনেস
বহুবছর	বছর
শাসকগোষ্ঠীর	শাসক
প্রবেশমুখ	প্রবেশ
ধরনটি	ধরন
চড়াই	চড়াই
দায়িত্বটি	দায়িত্ব
অনন্যার	অনন্যা
পল্লবীতে	পল্লবী
গোত্রভুক্ত	গোত্র
ঝগড়া	ঝগড়া
তারিফ	তারিফ
অতিবৃষ্টিতে	বৃষ্টি
আত্মহত্যার	হত্যা
কাসাভা	কাসাভা
মুসলমানরা	মুসলমান
আজাদি	আজাদ
কঙ্গনা	কঙ্গনা
কোঁকড়া	কোঁকড়া
স্টারলিং	স্টারলিং
বাছুরকে	বাছুর
সোশাল	সোশাল
বিশৃঙ	শৃঙ
জ্বালাও	জ্বালা
ইন্ডাকশন	ইন্ডাকশন
বিবেকহীন	বিবেক
ছাগলকে	ছাগল
প্রশ্নকাঠামো	প্রশ্নকাঠামো
ক্র্যাশ	ক্র্যাশ
অভিবাসন	অভি
মাই	মাই
মুর্শিদাবাদের	মুর্শিদাবাদ
ইফিষীয়	ইফিষী
আদলের	আদল
ভাবো	ভাবো
দুর্যোগ	দুর্যোগ
ঘনত্বের	ঘন
সফরেও	সফর
পড়া	পড়
চিটা	চিটা
নোহ	নোহ
হরিহর	হরি
রন্ধনশৈলীতে	রন্ধন
রিকশাচালককে	রিকশা
মনীশ	মন
ওয়্যারলেস	ওয়্যারলেস
উপক্রম	উপক্রম
কুয়াশায়	কুয়াশা
পরিবেশনের	পরিবেশন
টিউটোরিয়াল	টিউটোরিয়াল
অলৌকিক	লৌকিক
গুপ্তছড়া	গুপ্ত
রাখলো	রাখল
ভাববিনিময়	ভাব
নদীটিকে	নদী
অকৃতজ্ঞ	কৃতজ্ঞ
কমু	কমু
ঠেকায়	ঠেকা
খুলেছে	খুল
ইম্প্যাক্ট	ইম্প্যাক্ট
বাচ্চাটির	বাচ্চা
মাইক্রো	মাইক্রো
আয়াক্সের	আয়াক্স
পুলিস	পুলিস
হত্যাকান্ড	হত্যাকান্ড
পৃষ্ঠপোষকদের	পৃষ্ঠপোষক
পুষ্টিকর	পুষ্টি
পেইজ	পেইজ
পারোনি	পারো
সুখে	সুখ
এস্তোনিয়ায়	এস্তোনিয়া
কৌর	কৌর
বাস্তবভিত্তিক	বাস্তব
বক্ররেখা	বক্ররেখা
কার্বারি	কার্বারি
দূরপাল্লার	দূরপাল্লা
নারী	নারী
কাটছে	কাটছে
খেই	খেই
তাপবিদ্যুৎ	পবিদ্যুৎ
চিতিয়ে	চিতিয়ে
সেলুন	সেলুন
কাটায়	কাটায়
লিওঁ	লিওঁ
বুলেভার্ড	বুলেভার্ড
রহস্যটা	রহস্য
হস্তনির্মিত	হস্তনির্মিত
ভুটান	ভুটান
রচনাগুলির	রচনা
ধ্বংসযজ্ঞের	ধ্বংস
দায়িত্বেও	দায়িত্ব
গবেষকদের	গবেষক
কর্মীদেরও	কর্মী
বেশিক্ষণ	বেশিক্ষণ
উপবৃত্তীয়	বৃত্ত
উপহাস	হাস
মস্কোর	মস্কো
ক্লিন্ট	ক্লিন্ট
ধাঁধাঁ	ধাঁধাঁ
ব্যাপারও	ব্যাপার
ঝামেলাটা	ঝামেলা
প্রথমার্ধের	প্রথমার্ধ
পরিচারকের	পরিচারক
ইস্যুগুলো	ইস্যু
বর্ষা	বর্ষা
শাহরিয়ারের	শাহরিয়ার
কতজনের	জন
ব্যাংকগুলোর	ব্যাংক
বালিকাকে	বালিকা
ক্যারিয়ারের	ক্যারিয়ার
ফোয়ারা	ফোয়ারা
টাইগারদের	টাইগার
ফেরী	ফেরী
ডেটোনা	ডেটোনা
চিত্রনায়িকা	চিত্রনায়িকা
বৃহস্পতির	বৃহস্পতি
উৎপাদনও	উৎপাদন
পৌঁছেছিল	পৌঁছে
বিশ্লেষক	বিশ্লেষক
ভবিষ্যৎ	ভব
ভেনম	ভেনম
বাড়িতেই	বাড়ি
বদ্ধপরিকর	বদ্ধপরিকর
বেডরুম	বেড
সরকারপক্ষের	সরকার
অভিপ	অভিপ
পলাশীর	পলাশী
সুযোগসন্ধানী	সুযোগ
আসবে	আস
দায়ীদের	দায়ী
শিক্ষাপ্রাপ্ত	শিক্ষা
দাবানলের	দাবানল
ডেপুটি	ডেপুটি
নিপীড়নবিরোধী	পীড়ন
বিসিএলে	বিসিএল
ধোঁয়াশার	ধোঁয়াশা
মানিকছড়ি	মানিকছড়ি
রিবন	রিবন
নরওয়েয়ান	নরওয়ে
তথাগত	তথা
সিইও	সিইও
মলিন	মলিন
আটকানো	আটকানো
জলাবদ্ধ	জল
ইমো	ইমো
কাজির	কাজ
পণ্যগুলিতে	পণ্য
আলেখ্য	আলেখ্য
বঞ্চনার	বঞ্চনা
পাদ	পাদ
প্রমোশনাল	প্রমোশনাল
কয়া	কয়া
আহমেদুল	আহমেদুল
সুকান্ত	সুকান্ত
মোজাইক	মোজাইক
বিশ্ব	বিশ্ব
ক্ষুব্ধ	ক্ষুব্ধ
বৈচিত্র্যময়	বৈচিত্র্য
ইছাপুর	ইছাপুর
ন্যায়বিচারের	ন্যায়
বাজারগুলো	বাজার
তন্ময়ের	তন্ময়
এপিসোডে	এপিসোড
মূলনীতির	মূল
কাহাকেও	কাহাকে
সূর্যালোক	সূর্যালোক
গুণনীয়ক	গুণনীয়ক
আবিষ্কর্তা	আবিষ্কর্তা
ঢাকায়	ঢাকা
পাবেনা	পাবে
যুদ্ধংদেহী	যুদ্ধ
আজমি	আজমি
যাণকর	যাণকর
দিনলিপি	দিনলিপি
গহ্বরের	গহ্বর
পাওয়ার	পাওয়া
প্রেমিকার	প্রেমিক
ভেন্যুর	ভেন্যু
তুলিয়া	তুল
কিংসলে	কিংসল
পিস্তলে	পিস্তল
প্রতিষ্ঠাবার্ষিকীতে	প্রতিষ্ঠা
উচ্চমাত্রার	উচ্চমাত্রা
ডিস্কো	ডিস্ক
টাইপরাইটার	টাইপ
প্রথমবারে	প্রথমবার
এমনকি	এমন
চালনা	চালনা
ওঠাও	ওঠা
নাটুকে	নাটুক
পুনর্মিলনের	মিলন
একদৃষ্টিতে	দৃষ্টি
গড়েছিল	গড়
পড়া	পড়
প্রভাতফেরি	প্রভাত
সিনহা	সিনহা
পাহাড়ধসে	পাহাড়
হইল	হই
শিক্ষাবর্ষ	শিক্ষাবর্ষ
মদে	মদ
ইয়াও	ইয়া
হাসিমুখ	হাসি
ইঞ্জিনের	ইঞ্জিন
স্ট্রেচিং	স্ট্রেচিং
মন্ত্রণালয়ও	মন্ত্রণালয়
প্রমাণগুলো	প্রমাণ
চটের	চট
অন্তবর্তীকালীন	অন্তবর্তী
অপব্যয়ী	ব্যয়
শ্যালক	শ্যালক
কথায়	কথা
কাজি	কাজি
কম্বোজ	কম্বোজ
ওয়ার্ডের	ওয়ার্ড
পল্টনে	পল্টন
মেগাহার্জ	মেগাহার্জ
সুজিত	সুজিত
ফিশারের	ফিশার
দেয়ার	দেয়
রায়পুরের	রায়পুর
দেশটা	দেশ
ওপাশে	পাশ
স্নাইপার	স্নাইপার
আরটি	আরটি
সাজিদা	সাজিদা
কিতাবুল	কিতাব
আশীর্ব্বাদ	আশীর্ব্বাদ
পথরোধ	পথরোধ
দরপত্র	দর
তোজাম্মেল	তোজাম্মেল
রেসিডেন্স	রেসিডেন্স
কার্যক্রমটি	কার্য
সংঘে	সংঘ
আঘাতটা	আঘাত
গণচীনের	গণচীন
মুরব্বিদের	মুরব্বি
হাতিরঝিল	হাতিরঝিল
অঙ্কটা	অঙ্ক
তিনের	তিন
সালভাদরের	সালভাদর
হায়দারের	হায়দার
পুরুষও	পুরুষ
প্রসেনজিৎ	প্রসেনজিৎ
নবীনদের	নবীন
যথাকালে	যথা
প্লেতে	প্লে
মেজে	মেজ
পানামা	পানামা
সন্নিবেশ	বেশ
কলঙ্কজনক	কলঙ্ক
সমীকরণ	সমীকরণ
প্রজ্ঞাপনে	প্রজ্ঞা
ফারিহা	ফারিহা
কাটান	কাটা
অগ্নিকান্ড	অগ্নি
স্বভাবের	স্বভাব
টাওয়ারটি	টাওয়ার
গীর্জার	গীর্জা
স্কুলগুলো	স্কুলগুলো
চাঁদাবাজদের	চাঁদ
লেডিজ	লেডিজ
সেবার	সেবা
খাম্বা	খাম্বা
মায়	মা
দক্ষ	দক্ষ
বুখারেস্ট	বুখার
রাজনীতিকেরা	রাজনীতি
এব্রাহাম	এব্রাহাম
আপতন	আপতন
রঘুনন্দন	রঘুনন্দন
রেজিস্ট্রিতে	রেজিস্ট্রি
ইয়ারে	ইয়ার
হাঙ্গরের	হাঙ্গর
থাইল্যান্ডকে	থাইল্যান্ড
সার্ন	সার্ন
উপাদানে	উপাদান
ব্লুম	ব্লুম
জিনিসপত্র	জিনিস
ভিডিপি	ভিডিপি
মৌসুমী	মৌসুম
ধর্মপুর	ধর্ম
সন্ধ্যায়	সন্ধ্যা
ডিসেম্বরে	ডিসেম্বর
প্রচারণাকে	প্রচার
খাদ্যদ্রব্য	খাদ্য
বৈকি	বৈকি
কার্যাদেশ	দেশ
জুরাসিক	জুরাসিক
নৌমন্ত্রীর	মন্ত্রী
প্রায়শই	প্রায়শ
কড়ই	কড়ই
দেখলো	দেখলো
যুগের	যুগ
লিকার	লিকার
শিক্ষানীতির	শিক্ষানীতি
রাণীকে	রাণী
ওভারটি	ওভার
মিঠুনের	মিঠুন
চুয়াডাঙ্গায়	চুয়াডাঙ্গা
ছটফট	ছটফট
একনায়ক	একনায়ক
সাহিত্যকর্ম	সাহিত্য
জাকের	জাকের
স্ত্রীরোগ	স্ত্রী
অভাব	ভাব
এইসব	সব
শালুক	শাল
সান্তিয়াগো	সান্তিয়াগো
চারু	চারু
মানমন্দির	মন্দির
গাঁজাসহ	গাঁজা
জৈবিকভাবে	জৈব
লিগেই	লিগ
মাহবুবউদ্দিন	মাহবুবউদ্দিন
ফলস্বরূপ	ফল
ব্যাবেজ	ব্যাবেজ
বেকার	বেকার
সাপ্লিমেন্ট	সাপ্লিমেন্ট
মোকাবেলার	মোকাবেলা
ফ্রুট	ফ্রুট
ইসলামী	ইসলাম
দোযখী	দোযখ
ভুলে	ভুল
শ্রীমতি	শ্রীমতি
মিউনিসিপ্যাল	মিউনিসিপ্যাল
কিবোর্ড	কিবোর্ড
নেপচুনের	নেপচুন
রপ্তানিকারক	রপ্তানি
দশটার	দশ
দোকানিরা	দোকান
ভিওআইপি	ভিওআইপি
আমর	আমর
ডিএনডি	ডিএনডি
রাজশ্রী	রাজ
ডেফিনেশন	ডেফিনেশন
অক্সিডেশন	অক্সিডেশন
নাফিস	নাফিস
ভাজ্য	ভাজ্য
একহাত	একহাত
প্রকৌশলের	প্রকৌশল
বাঙালির	বাঙাল
মনসার	মনসা
গোয়েন্দা	গোয়েন্দা
ডালের	ডাল
দোষের	দোষ
পরিবারটির	পরিবার
জেহাদের	জেহা
হাইড্রোক্সাইড	হাইড্রোক্সাইড
ফজিলত	ফজিলত
ট্যাংকারের	ট্যাংকার
অভিযানের	অভিযান
তালিবের	তালিব
বান্দর	বান্দর
বিচারবহির্ভূত	বিচার
বন্দুকযুদ্ধে	বন্দুক
খোন্দকার	খোন্দকার
হিজাব	হিজাব
ভালোলাগার	ভালোলাগা
দিয়েছিস	দিয়েছি
এসবের	এসব
ভিদাল	ভিদাল
জহুর	জহুর
স্বেচ্ছাসেবীরা	স্বেচ্ছাসেবী
স্পোর্টসের	স্পোর্টস
জাহান্নামে	জাহান্নাম
নীরা	নীরা
আলোচনা	আলোচনা
জনম	জনম
লেসের	লেস
প্রচেষ্টাটি	প্রচেষ্টা
শৃঙ্খলিত	শৃঙ্খল
পিলখানায়	পিলখানা
খামেনির	খামেনি
চয়নিকা	চয়নিকা
ভিখারি	ভিখারি
নির্ভরযোগ্যভাবে	নির্ভর
বিচারক	বিচার
হিট	হিট
সমঞ্জসে	সমঞ্জস
রিড	রিড
তাইতো	তাই
আইয়ুবের	আইয়ুব
স্টেডিয়ামেই	স্টেডিয়াম
ব্যঞ্জনবর্ণের	ব্যঞ্জনবর্ণ
ছানি	ছানি
মলয়	মলয়
পল্টনের	পল্টন
মুখোশধারী	মুখোশ
পরীক্ষাটা	পরীক্ষা
মানাবে	মানাব
সরকারও	সরকার
বজনদের	বজন
পানিতেই	পানি
মুখবন্ধ	মুখবন্ধ
খারিজের	খারিজ
আটটি	আট
পারমানবিক	পারমানবিক
শুনিবে	শুনিব
গার্লফ্রেন্ড	গার্লফ্রেন্ড
ঋষির	ঋষি
অনেকখানি	অনেক
স্বতঃস্ফূর্ততা	স্বতঃস্ফূর্ত
সচিবসহ	সচিব
মনোবল	মনোবল
ঢাকাসহ	ঢাকা
দ্ধ	দ্ধ
গানটিতে	গান
সোহ্	সোহ
শ্রেণীকক্ষের	শ্রেণী
শহীদুল্লা	শহীদুল্লা
আববাস	আববাস
রহিমা	রহিমা
সমান্তরালভাবে	সমান্তরাল
চিত্র	চিত্র
স্ন্যাকস	স্ন্যাকস
বিচারকাজ	বিচার
বর্ধিষ্ণু	বর্ধিষ্ণু
ঘনফুট	ফুট
অসন্তোষ	সন্তোষ
আব্বাকে	আব্বা
আজকে	আজ
যৌনপল্লিতে	যৌনপল্লি
বহরমপুর	বহরমপুর
বারোটার	বারো
মঈনের	মঈন
সন্ধ্যাবেলা	সন্ধ্যা
সাদিক	সাদিক
মহকুমা	মহকুমা
তথ্যে	তথ্য
হতো	হতো
ধরায়	ধরা
মনস্থির	স্থির
ব্লক	ব্লক
হামলাটি	হামলা
সহজবোধ্য	সহজ
নজরুলগীতি	নজরুল
রেক্টর	রেক্টর
আদর্শগত	আদর্শ
মধ্যরাতে	রাত
যৌনপল্লি	যৌন
পাট	পাট
দেখছিস	দেখ
ঝুমকা	ঝুমকা
অশোকের	অশোক
চিকিৎসাবিজ্ঞান	চিকিৎসা
শাকসবজির	সবজি
ফাজিলপুর	ফাজিলপুর
এবতেদায়ী	এবতেদায়ী
সোয়াইন	সোয়াইন
বিজয়ী	বিজয়
ঢোলের	ঢোল
মেখলা	মেখলা
গোসল	গোসল
ধ্যান	ধ্যান
এশিয়া	এশিয়া
নিঃশব্দ	শব্দ
সমাজতন্ত্র	সমাজ
ইউনিটিতে	ইউনিটি
অতীন	অতীন
উশুল	উশুল
কাশ্মীরী	কাশ্মীর
বোনে	বোন
দেশসমূহের	দেশ
আইএসপিআর	আইএসপিআর
সুবিধাবঞ্চিত	সুবিধা
বোঝাপড়ার	বোঝা
জুভেন্টাসের	জুভেন্টাস
কৃষিজমির	কৃষি
ওয়ার্নিং	ওয়ার্নিং
মর্মাহত	মর্মাহত
সম্বন্ধেই	সম্বন্ধ
পূর্ণসময়ের	পূর্ণসময়
পরিবারটিকে	পরিবার
সার্ক	সার্ক
সুধীন	সুধীন
মেধাবৃত্তি	মেধা
সমস্যার	সমস্যা
এমটিবি	এমটিবি
বৈচিত্রতা	বৈচিত্র
রমনি	রমনি
আবেশে	আবেশ
হটাও	হটা
সারু	সারু
কোনটি	কোন
লেফট	লেফট
যথার্থই	যথার্থ
মোজা	মোজা
টেরাহার্জ	টেরাহার্জ
মশলাদার	মশলা
বাণীকে	বাণী
কাঁটাযুক্ত	কাঁটা
কাস্টমাইজেশন	কাস্টমাইজ
সুইভেল	সুইভেল
হুঁশিয়ারি	হুঁশিয়ার
ফসলি	ফসল
বলিউডি	বলিউডি
ল্যান্ডফোন	ফোন
সাত্তার	সাত্তার
লাভা	লাভা
আটা	আটা
বানাবেন	বানাব
গডফাদারদের	ফাদার
মোকদ্দমার	মোকদ্দমা
গেমে	গেম
তুললেও	তুলল
করেছিস	করেছি
বাশার	বাশার
ধাপেই	ধাপ
দৃষ্টিকোণে	দৃষ্টিকোণ
কাবিননামা	কাবিন
ইতি	ইতি
কানসাই	কান
কিলোগ্রাম	কিলোগ্রাম
হজযাত্রীর	হজ
পাপাচারী	পাপাচার
চোরে	চোর
রাদামেল	রাদামেল
লর্ড	লর্ড
রোযা	রোযা
ভঙ্গিতে	ভঙ্গি
মজিদকে	মজিদ
বিদেশিসহ	দেশ
রিচি	রিচি
ক্রিকেটীয়	ক্রিকেট
মানুষটার	মানুষ
বরফের	বরফ
ঈগল	ঈগল
অ্যাস্ট্রোনমিক্যাল	অ্যাস্ট্রোনমিক্যাল
বায়োপিক	বায়োপিক
হওয়ায়	হওয়া
মিজানের	মিজান
হাফিজ	হাফিজ
পক্ষটি	পক্ষ
প্রহরীকে	প্রহর
ভিজ্যুয়াল	ভিজ্যুয়াল
পদযাত্রার	পদযাত্রা
তায়েব	তায়েব
নেভাদা	নেভা
পরিপাটি	পরিপাট
অ্যাকাউন্ট্যান্টস	অ্যাকাউন্ট
জাফরকে	জাফর
ক্যাপাসিটর	ক্যাপাসিটর
সাক্ষ্যগ্রহণের	সাক্ষ্য
উলি	উল
জিআইএস	জিআইএস
কমিউনিটি	কমিউনিটি
সমুহের	সমুহ
যুক্তি	যুক্ত
উচ্চহারে	উচ্চ
সফটওয়্যারগুলো	সফটওয়্যার
আয়ান	আয়ান
গ্রামটি	গ্রাম
দাসী	দাসী
সিন্দুকে	সিন্দুক
ফিটের	ফিট
বিপ্লবীরা	বিপ্লব
প্রচারিত	প্রচার
ক্লোজার	ক্লোজ
বিপ্লবের	বিপ্লব
মঞ্চনাটক	নাটক
নজিবুল্লাহ	নজিবুল্লাহ
সঙ্কটে	সঙ্কট
পারেননি	পার
নারভিকের	নারভিক
ঝরনার	ঝরনা
দুঃসাহসিক	সাহস
আম্মু	আম্মু
মাদকসেবী	মাদক
লাগলঃ	লাগল
কতই	কত
কূপ	কূপ
ভয়ংকর	ভয়ংকর
প্যাসিভ	প্যাসিভ
ম্যাচেই	ম্যাচ
আর্টসের	আর্টস
সত্য	সত্য
ফাটা	ফাটা
অনুরোধকৃত	অনুরোধ
চৌহাট্টা	চৌহাট্টা
যুদ্ধবন্দী	যুদ্ধ
কারটি	কার
রুশনারা	রুশনারা
ব্যাকরণ	ব্যাকরণ
ব্রাশের	ব্রাশ
শাজাহান	শাজাহান
টেকের	টেক
জরায়ুতে	জরায়ু
জনগন	জনগন
মোর্শেদ	মোর্শেদ
স্তর	স্তর
মিরপুর	মিরপুর
শতরঞ্জি	শতরঞ্জি
আজানের	আজান
ব্লুমবার্গের	ব্লুমবার্গ
নেতৃত্বে	নেতৃত্ব
ব্যপার	ব্যপার
প্রত্যক্ষদর্শীরা	প্রত্যক্ষ
সমন্বয়	সমন্বয়
বোম্বাই	বোম্বাই
অ্যামেরিকা	অ্যামেরিকা
নেশাজাতীয়	নেশা
ক্যালেন্ডারে	ক্যালেন্ডার
কেইস	কেইস
জামাতার	জামাতা
শুনিতে	শুন
ভাষাতত্ত্বের	ভাষাতত্ত্ব
দর্শককে	দর্শক
ইনবক্সে	ইনবক্স
ধর্মবিশ্বাসের	ধর্মবিশ্বাস
নিশ্চিত	নিশ্চিত
উদীয়মান	উদীয়মান
অ্যানালিটিকা	অ্যানালিটিকা
সমাজকর্মী	সমাজকর্মী
মাইক্রোওয়েভ	মাইক্রোওয়েভ
অ্যালি	অ্যালি
সৎকাজের	সৎকাজ
পাব	পাব
সায়েন্সেস	সায়েন্স
নেতৃত্বস্থানীয়	নেতৃত্ব
পাংক	পাংক
সুনীল	সুনীল
দাওয়ায়	দাওয়া
ভ্যাটিকানের	ভ্যাটিকান
ঝিম	ঝিম
ফেঁপে	ফেঁপে
বৃহষ্পতিবার	বৃহষ্পতি
নাচের	নাচ
পুকুরে	পুকুর
সহকর্মীর	সহকর্মী
দ্বিধায়	দ্বিধা
মার্গারিটা	মার্গ
শিশুসন্তানকে	সন্তান
জোটটি	জোট
বাবুর	বাবু
ম্যাসেডোনিয়ার	ম্যাসেডোনিয়া
পলে	পল
কালোর	কালো
নিষ্ক্রিয়	নিষ্ক্রিয়
এড়ানো	এড়ান
প্রিন্টার	প্রিন্ট
ভণ্ডামি	ভণ্ড
ঝিকিমিকি	ঝিকি
সুইস	সুইস
জালিয়াতিতে	জালিয়াতি
এমন	এমন
সর্বনাম	সর্বনাম
এনভিআর	এনভিআর
ভীরু	ভীরু
স্বেচ্ছাশ্রমের	স্বেচ্ছা
মঞ্চটি	মঞ্চ
মিছিলে	মিছিল
যেতো	যেতো
মালপত্রের	মাল
নিঃসরণ	নিঃসরণ
আপামর	আপামর
হ্যাভেন	হ্যাভেন
সোনাটা	সোনা
বেল্লাল	বেল্লাল
বলছিলেন	বল
কম্পোস্ট	কম্পোস্ট
অন্তভাঁজ	অন্তভাঁজ
উপার্জন	উপ
ভূপতি	ভূপতি
অঙ্গহানি	অঙ্গ
তথ্যসচিব	তথ্য
বোসের	বোস
সেপ্টেম্বর	সেপ্টেম্বর
বক্তৃতাগুলো	বক্তৃতা
অধিবাসী	অধিবাসী
সাক্ষ্য	সাক্ষ্য
ভোরেই	ভোর
সফরসঙ্গী	সফর
অফশোর	অফশো
রিপ্লেতে	রিপ্লে
স্কলারশিপ	স্কলার
বাছাইপর্বে	বাছাইপর্ব
অভ্যন্তরস্থ	অভ্যন্তর
ফেরালেন	ফেরা
সাম্রাজ্যে	সাম্রাজ্য
শক্তিস্তর	শক্তি
সড়কজুড়ে	সড়ক
সুশ্রী	সুশ্রী
যাঁরা	যাঁর
মাচার	মাচা
হারূনের	হারূন
ইউরোপসহ	ইউরোপ
হঠকারিতা	হঠকারি
গুন	গুন
সফররত	সফর
বিবরণীতে	বিবরণ
মোতালেব	মোতালেব
আস্থাশীল	আস্থা
ঘোড়দৌড়	ঘোড়দৌড়
সুমাত্রা	সুমাত্রা
হ্যারি	হ্যারি
শুভকামনা	শুভকামনা
মালয়েশিয়ার	মালয়েশিয়া
সাজাই	সাজ
সান্ত্বনা	সান্ত্বনা
বিষয়গুলোতে	বিষয়
পাহাড়গুলোকে	পাহাড়গুলো
চাকুরীর	চাকুরী
ক্লেয়ার	ক্লেয়ার
তুরিনে	তুরিন
কাকের	কাক
রচনাগুলি	রচনা
সকলেরই	সকল
ক্রিকেটেও	ক্রিকেট
শূন্যপদ	শূন্যপদ
বাহাদুর	বাহাদুর
কয়েকদিনের	দিন
স্থলচর	স্থল
উপলব্ধি	লব্ধ
আলোচ্য	আলোচ্য
লেখেননি	লেখ
জন্মদিনের	জন্মদিন
পদবঞ্চিতদের	পদবঞ্চিত
লংকা	লংকা
ঈর্ষার	ঈর্ষা
শীতলতম	শীতল
হৃৎপিন্ডের	হৃৎপিন্ড
পিয়ানোবাদক	পিয়ানো
লুটিয়ে	লুটিয়ে
কেপটাউন	কেপটাউন
আকৃতির	আকৃতি
অনুভূমিক	ভূমি
সময়টি	সময়
সময়টুকু	সময়
দিই	দিই
যথাযোগ্য	যোগ্য
বহুব্রীহি	বহুব্রীহি
ধরাই	ধর
সুষ্ঠ	সুষ্ঠ
মগজে	মগজ
ইয়ামাহা	ইয়ামাহা
ভয়ও	ভয়
সরকারপন্থী	সরকার
যৌনাঙ্গ	যৌন
হীনম্মন্যতা	হীনম্মন্য
নিরাপত্তারক্ষীদের	নিরাপত্তা
ডায়েরিতে	ডায়েরি
পেঁচানো	পেঁচানো
ডাকলে	ডাক
শেষও	শেষ
শেয়ারধারীদের	শেয়ারধারী
এতটুকু	এতটুকু
ভ্রাতার	ভ্রাতা
আর্মেনীয়দের	আর্মেনীয়
ট্রস	ট্রস
মেম্বাররা	মেম্বার
শাপলাপুর	শাপলাপুর
চরমপন্থার	চরমপন্থা
সুচারুভাবে	সুচারু
বন্দরগুলি	বন্দর
সেটি	সে
বয়লার	বয়লার
চিত্রায়ণ	চিত্র
ডিরেক্টরের	ডিরেক্টর
সমষ্টিকে	সমষ্টি
রিচা	রিচ
পৃথক	পৃথক
হুগলি	হুগলি
কুকিং	কুক
জোক	জোক
চারদলীয়	চারদল
অর্ক	অর্ক
শেষমেষ	শেষমেষ
মস্তিষ্কের	মস্তিষ্ক
কমান্ডারস	কমান্ড
ওয়ে	ওয়ে
ট্র্যাক্ট	ট্র্যাক
আলবেনিয়ান	আলবেনিয়ান
অঙ্গভঙ্গির	অঙ্গ
প্রদানকে	প্রদান
রাইডের	রাইড
মাটির	মাটি
কন্ডিশনের	কন্ডিশন
কিডনিতে	কিডনি
এভিএন	এভিএন
কুবরা	কুবরা
অডিট	অডিট
রন্ধনশৈলীর	রন্ধন
মতান্তরে	মত
স্টেক	স্টেক
স্মরণার্থে	স্মরণ
মসুলে	মসুল
গবেষকের	গবেষক
চামড়ার	চামড়া
উসমানের	উসমান
নির্বাচনগুলোতে	নির্বাচন
কুয়াশা	কুয়াশা
মির্জ্জা	মির্জ্জা
বামনডাঙ্গা	বামনডাঙ্গা
ভিভিআইপি	ভিভিআইপি
পেশাদারি	পেশা
কর্মসূচির	কর্ম
লুৎফুজ্জামান	লুৎফুজ্জামান
ডাইরেক্টর	ডাইরেক্ট
দিকনির্দেশনার	নির্দেশনা
নিটওয়্যার	নিটওয়্যার
প্রযোজকের	প্রযোজক
চলেই	চলে
চারগুণ	চার
অভিযোগের	যোগ
স্কোয়ারে	স্কোয়ার
সেনানিবাসের	সেনানিবাস
নর্দমার	নর্দমা
কিশোরীর	কিশোরী
যের	যের
ইলিশের	ইলিশ
ময়দান	ময়দান
থুবড়ে	থুবড়ে
সামগ্রী	সামগ্রী
সম্মেলনেও	সম্মেলন
বাচ্চাসহ	বাচ্চা
মহল্লা	মহল্লা
কওয়া	কওয়া
অটিজম	অটিজম
ভাষাটির	ভাষা
তুরান	তুরান
উইলিয়ামের	উইলিয়াম
পার্কে	পার্ক
কুয়া	কুয়া
প্রেমচাঁদ	প্রেমচাঁদ
ক্ষয়ে	ক্ষয়
সভ্য	সভ্য
ভবিষ্যদ্বাণীমূলক	ভবিষ্যদ্
বন্দুকধারীরা	বন্দুকধারী
সময়টিই	সময়
জিহাদিদের	জিহাদ
সিঙ্গারের	সিঙ্গার
সম্পাদকীয়	সম্পাদক
বিদায়ী	বিদায়
বোতলটা	বোতল
সদরঘাট	সদরঘাট
মেয়ররা	মেয়র
রিপন	রিপন
পানশালায়	পান
মাঝারি	মাঝ
বিস্ফোরণে	বিস্ফোরণ
উদ্দীপকটি	উদ্দীপক
সাফল্যের	সাফল্য
মহড়ায়	মহড়া
মামলাগুলো	মামলা
সোনারপুর	সোনারপুর
যুক্তরাজ্যকে	যুক্তরাজ্য
আত্মনিয়োগ	আত্ম
সুকেন্দ্রিক	কেন্দ্র
যুগান্তকারী	যুগান্ত
ক্রিকেটে	ক্রিকেট
বৈশিষ্ট্য	বৈশিষ্ট্য
বধের	বধ
ঢালিউড	ঢালিউড
ভালবাসতাম	ভাল
প্রভাবও	প্রভাব
গুণফলের	গুণফল
ব্যারেজ	ব্যারেজ
ফয়সালা	ফয়সালা
অতিকায়	অতিকা
নিঃসঙ্গতা	সঙ্গ
হোয়াইট	হোয়াইট
মানত	মানত
অর্থাত	অর্থ
মনিরামপুরের	মনিরামপুর
শিখেন	শিখ
জন্মেছিলেন	জন্ম
মূল্যস্ফীতির	মূল্য
আরএফআইডি	আরএফআইডি
জুতো	জুতো
ক্যারিবীয়রা	ক্যারিবীয়
ফুলবাড়িয়া	ফুলবাড়িয়া
টার	টার
প্রদর্শনীটি	প্রদর্শন
প্রতিষ্ঠাতা	প্রতিষ্ঠা
এতোটাই	এতো
সম্পাদন	সম্পাদন
এরফলে	ফল
পিএইচপি	পিএইচপি
গুঞ্জন	গুঞ্জন
চরণে	চরণ
মোজাবিশেষ	মোজা
সহশিক্ষা	শিক্ষা
মাবিয়া	মাবিয়া
বর্জনের	বর্জন
কপূর	কপূর
খ্রিষ্টমাস	খ্রিষ্ট
প্যাট্রিয়ট	প্যাট্রিয়ট
ব্যতিরেকেই	ব্যতিরেক
মোডেম	মোডেম
মহাখালীর	মহাখালী
অ্যাটলাস	অ্যাটলাস
নির্দেশকে	নির্দেশ
রাজনীতির	রাজনীতি
মাতামুহুরী	মাতামুহুরী
ত্রাণকর্তা	ত্রাণ
আটপৌরে	আটপৌরে
কিউকিউ	কিউ
উৎপল	উৎপল
ফেরেশতাদের	ফেরেশতা
এয়াকিনসের	এয়াকিনস
সেনেগাল	সেনেগাল
লক্ষ্যকে	লক্ষ্য
কার্যকলাপ	কার্য
যতটুকু	যতটুকু
যাত্রার	যাত্রা
ছামাদ	ছামাদ
সেলসিয়াসে	সেলসিয়াস
সপ্তর্ষি	সপ্তর্ষি
প্রতিবাদে	প্রতিবাদ
বিশ্ববিদ্যালয়ের	বিশ্ববিদ্যালয়
মাত্র	মাত্র
হরিজন	হরিজন
সরকারকে	সরকার
ব্যাঙ্গাত্মক	ব্যাঙ্গ
ক্যাচিং	ক্যাচ
চাং	চা
টানছে	টান
প্রসেসরের	প্রসেসর
দলবদলের	দল
ম্যাল	ম্যাল
আকৃতিটি	আকৃতি
পথ্য	পথ্য
অপার	অপার
রাজিয়া	রাজি
সড়কটির	সড়ক
সুমন্ত	সুমন্ত
ন্যায়পাল	ন্যায়পাল
নেপচুন	নেপচুন
বিজ্ঞানচিন্তা	বিজ্ঞান
আক্তারের	আক্তার
বুদ্ধিবৃত্তি	বুদ্ধি
সপ্তম	সপ্তম
ডেথ	ডেথ
কামারপুকুর	পুকুর
জেতার	জেতা
চক্রটির	চক্র
সহনশীলতা	সহন
গতিসীমা	গতি
উইমেন	উইমেন
ক্ষতিকারক	ক্ষতি
ফ্রেব্রুয়ারি	ফ্রেব্রুয়ারি
ডিআরএস	ডিআরএস
রামু	রামু
ঢিলেঢালা	ঢিলেঢালা
শপথগুলোকে	শপথ
গুরুত্বকে	গুরুত্ব
বার্নিকাট	বার্নিকাট
তেহরান	তেহরান
সিএমএস	সিএমএস
ডেন্ট	ডেন্ট
লিমিটেডকে	লিমিট
প্রচারকারী	প্রচার
তথ্যই	তথ্য
উইকস	উইকস
মাঠপর্যায়ে	মাঠপর্যায়
হালিশহর	শহর
কৃপণ	কৃপণ
আল্পস	আল্পস
যোশি	যোশি
যুদ্ধবিগ্রহ	যুদ্ধ
হোয়া	হোয়া
প্রবন্ধ	বন্ধ
মার্চকে	মার্চ
নিডল	নিডল
ডিএমপির	ডিএমপি
ক্লিয়ারেন্স	ক্লিয়ার
ইয়েমেন	ইয়েমেন
ভূত্বকের	ভূত্বক
জিম্বাবুয়ীয়	জিম্বাবুয়ীয়
গবাদি	গবাদি
আলেকজান্দ্রিয়ায়	আলেকজান্দ্রিয়া
মেদিনীপুরে	মেদিনীপুর
ধনবাড়ী	ধন
মুসলমানেরা	মুসলমান
এমসিসিআইয়ের	এমসিসিআই
বিরতির	বিরত
ব্যাপারটির	ব্যাপার
ওন্টারিও	ওন্টারি
ঋনাত্মক	ঋনাত্মক
থাকাটাই	থাকা
রিটার্নস	রিটার্ন
সাপ	সাপ
বৈতরণি	বৈতরণ
সমাজতন্ত্রের	সমাজতন্ত্র
ইকুয়েডর	ইকুয়েডর
অর্ডার	অর্ডার
বনকর্মীরা	বন
মেরিনার	মেরিনা
বর্ষসেরা	বর্ষ
বিষণ্নতায়	বিষণ্ন
বিষাদময়	বিষাদ
অস্বীকৃত	স্বীকৃত
ড্রাইভার	ড্রাইভার
মরিশাসের	মরিশাস
অনুপস্থিতির	অনুপস্থিত
প্রাণ	প্রাণ
রুমমেট	রুম
রাইফেলের	রাইফেল
বাল্যবন্ধু	বাল্যবন্ধু
বীজতলা	বীজ
আর্জেন্টাইনদের	আর্জেন্ট
বেইজিংয়ে	বেইজিং
নূপুর	নূপুর
সেটাতে	সেটা
ইহা	ইহা
দলা	দলা
ভূমিষ্ঠ	ভূমিষ্ঠ
সোল	সোল
চৈত্রসংক্রান্তি	চৈত্র
জেসিকা	জেসিকা
স্ন্যিং	স্ন্যিং
পলিব্যাগ	পলি
মরেছে	মর
পিএক্স	পিএক্স
অব্রামের	অব্রাম
এএফপি	এএফপি
কচুয়া	কচুয়া
তীর্থের	তীর্থ
ভারতসহ	ভারত
উপকারিতা	উপকার
মল্লিকপুর	মল্লিকপুর
মলম	মলম
স্থানগুলোকেও	স্থান
স্কাউটের	স্কাউট
আসছিল	আস
তেজস্ক্রিয়	তেজস্ক্রিয়
বস্তার	বস্তা
এজেন্সিতে	এজেন্সি
শিক্ষাবৃত্তি	শিক্ষাবৃত্তি
হরিনাথ	হরিনাথ
বাবাকে	বাবা
দাবিও	দাবি
সুযোগকে	সুযোগ
মমতাজউদদীন	মমতাজউদদীন
গোষ্ঠীগুলো	গোষ্ঠী
বাঁশতলা	বাঁশতলা
জিতিয়ে	জিত
ঘটনা	ঘটনা
পাইকারদের	পাইকার
অনুচিত	অনুচিত
প্রত্যঙ্গের	প্রত্যঙ্গ
হাসপাতালে	হাসপাতাল
কাস্টমারদের	কাস্টমার
প্রত্যয়ী	প্রত্যয়
সতর্কতার	সতর্কতা
পতৌদি	পতৌদি
বৃহস্পতিবারও	বৃহস্পতিবার
প্রদেশের	প্রদেশ
লাইনম্যান	লাইনম্যান
বৃদ্ধাশ্রম	বৃদ্ধ
পুচ্ছ	পুচ্ছ
গির্জায়	গির্জা
ইয়াকুবের	ইয়াকুব
ক্যাট	ক্যাট
খাটেন	খাট
ভোটটা	ভোট
গায়েবি	গায়েব
মহল	মহল
নিলয়ের	নিলয়
সুতায়	সুতা
নির্মাণে	নির্মাণ
আনছেন	আনছেন
বিশ্লেষকরা	বিশ্লেষক
সম্বন্ধে	সম্বন্ধ
কূপের	কূপ
জনসংখ্যা	জন
জিমেইলের	মেইল
পড়েছিলাম	পড়েছি
চলত	চল
রোমীয়রা	রোম
উত্তরাঞ্চলে	উত্তরাঞ্চল
রাইডারের	রাইডার
সোভিয়েত	সোভিয়েত
সনিয়া	সনিয়া
অসহিষ্ণুতা	সহিষ্ণু
সোনারগাঁও	সোনারগাঁও
সুমনকে	সুমন
হস্তাক্ষর	হস্ত
হাইব্রীড	ব্রীড
মর্টারের	মর্টার
যেমনই	যেমন
ফকনারের	ফকনার
পাঁচালী	পাঁচালী
এখানে	এখান
শাল	শাল
আয়োজন	আয়োজন
ফলাফলটা	ফলাফল
টিপুর	টিপু
দ্রুতবেগে	দ্রুতবেগ
আপনিই	আপনি
কার্লসন	কার্লসন
পেরিমিটার	পেরিমিটার
অপকেন্দ্র	কেন্দ্র
জরুরি	জরুরি
যেটি	যে
পদ্ধতিটি	পদ্ধতি
পেটেন্ট	পেটেন্ট
উল্লাহর	উল্লাহর
ফ্লোরেস	ফ্লোরেস
ম্যানিপুলার	ম্যানিপুলার
পলিটেকনিকের	পলিটেকনিক
প্রমাণীকরণ	প্রমাণ
ইয়েলো	ইয়েলো
কাজেরই	কাজ
সালা	সালা
তদন্তকালে	তদন্ত
মিডিয়ায়	মিডিয়া
হেইস	ইস
চাতালে	চাতাল
গাড়িটি	গাড়ি
মেলায়	মেলা
ম্যাকার্থি	ম্যাকার্থি
নিসর্গের	সর্গ
জিয়ো	জিয়ো
মিলেছিল	মিল
সিপিবির	সিপিবি
সাংহাইয়ের	সাংহাই
বিচারিত	বিচারিত
কষ্টগুলো	কষ্ট
ক্রমশই	ক্রমশ
বন্যায়	বন্যা
শ্বেতপত্র	শ্বেত
মৃতপ্রায়	মৃত
ফাটাফাটি	ফাটা
নিমিষেই	নিমিষেই
কেচুয়া	কেচুয়া
পাথরটা	পাথর
সবকটা	সব
স্কুলগুলির	স্কুল
অপ্রতিসাম্য	প্রতিসাম্য
পরিচালনাসহ	পরিচালনা
যাইয়া	যাই
বাদশার	বাদশা
পক্ষেরই	পক্ষ
ক্যাটরিনা	ক্যাটরিনা
সহনশীলতার	সহনশীল
মুদ্রাগুলি	মুদ্রা
গুণকীর্তন	কীর্তন
রণবীরের	রণবীর
করুণার	করুণা
কোরিয়া	কোরিয়া
প্রতিযোগে	যোগ
সাজানো	সাজ
ঘরটায়	ঘর
দোহা	দোহা
ব্যক্তিগতভাবে	ব্যক্তি
ক্রুসেডাররা	ক্রুসেডার
আলোকে	আলো
বিলি	বিলি
সেক্টর	সেক্টর
শিল্পকলায়	শিল্পকলা
বাড়িটি	বাড়ি
কোনরকম	কোনরকম
তৃণভূমিতে	তৃণভূমি
বইয়ের	বই
ফাইনালিস্ট	ফাইনাল
গানগুলোতে	গান
ডব্লিউভিএ	ডব্লিউভিএ
পীরজাদা	পীরজাদা
সিআরপি	সিআরপি
নেকড়ের	নেকড়ে
মালবাহী	মালবাহী
খেলাটাই	খেল
তোশক	তোশক
ভারতেরই	ভারত
নামঞ্জুর	নামঞ্জুর
আইএম	আইএম
দরিদ্রতা	দরিদ্র
ম্যা	ম্যা
প্রশ্নেরই	প্রশ্ন
বিভ্রান্তির	ভ্রান্তি
দায়ের	দায়
অফিসাররা	অফিসার
অনিবার্যভাবে	অনিবার্য
জন্যই	জন্য
ডিপো	ডিপো
বশ্যতা	বশ্য
অন্যদেরকে	অন্যদের
শঙ্কায়	শঙ্কা
মোৎসার্ট	মোৎসার্ট
বাড়িটি	বাড়ি
ক্লাবে	ক্লাব
ঝাড়গ্রাম	ঝাড়গ্রাম
গৃহবধূ	বধূ
উদয়পুর	উদয়পুর
রুতা	রুতা
ফেলুন	ফেল
আবারও	বার
অরণ্য	অরণ্য
নৌবহরের	নৌবহর
সুরমা	সুরমা
লিফ	লিফ
শব্দটিকে	শব্দ
সিওএ	সিওএ
ধর্মবিষয়ক	ধর্ম
ঈষৎ	ঈষৎ
জরিমানাসহ	জরিমানা
থিক	থিক
লুটেরাদের	লুটেরা
বেভারলি	বেভারলি
এন্টিভাইরাস	এন্টিভাইরাস
দোর	দোর
গেছিলো	গেছিল
আয়োডিন	আয়োডিন
নেদারল্যান্ডস	নেদারল্যান্ডস
কর্তৃত্বপরায়ণ	কর্তৃত্ব
অ্যালুমিনিয়ামের	অ্যালুমিনিয়াম
এনকোডিং	কোডিং
ডমিনিকান	ডমিনিকান
ব্লা	ব্লা
কবিগান	কবিগান
নদীটিতে	নদী
খালটির	খাল
উচ্ছাস	উচ্ছাস
ব্যক্তিত্বরা	ব্যক্তি
ফ্লস	ফ্লস
সংস্থানের	সংস্থান
ছায়াপথে	ছায়া
ব্রেইন	ব্রেইন
লেফটেনেন্ট	লেফটেনেন্ট
জুজু	জুজু
ড্রয়ারে	ড্রয়ার
সফটওয়্যারে	সফটওয়্যার
খ্রীষ্টধর্মের	খ্রীষ্টধর্ম
পেশাদাররা	পেশাদার
বিষধর	বিষ
বিবাদ	বিবাদ
সংবিধানকে	সংবিধান
ইংরাজি	ইংরাজি
ব্যবধানে	ব্যবধান
বোলিংয়ে	বোল
ত্যাগ	ত্যাগ
সম্মেলক	সম্মেলক
ড্যান	ড্যান
লেজ	লেজ
লাঙ্গলের	লাঙ্গল
আসীন	আসীন
মুষ্টিবদ্ধ	মুষ্টি
ফ্রেন্ড	ফ্রেন্ড
লইতে	লইত
ভাওয়াল	ভাওয়াল
জেনেট	জেনে
তর্কে	তর্ক
উপসাগরীয়	উপসাগর
ভালোভাবেই	ভালো
বুড্ডিস্ট	বুড্ডিস্ট
উজ্জ্বলতম	উজ্জ্বল
সাহিদুল	সাহিদুল
ছোঁয়া	ছোঁয়া
যোগ্যতম	যোগ্য
সিল্কি	সিল্ক
সারগর্ভ	সার
গোলাম	গোলাম
অপশক্তি	শক্তি
পরমানন্দ	পরমানন্দ
শ্রীপুরে	শ্রীপুর
ঢাকতে	ঢাকত
বাড়িটার	বাড়ি
বুলগেরিয়ান	বুলগেরিয়া
সাহু	সাহু
কেজিএফ	কেজিএফ
ডেবিট	ডেবিট
তেঁতুলের	তেঁতুল
পাঠাইয়া	পাঠা
দাবীর	দাবী
যবেহ	যবে
বৈচিত্র্য	বৈচিত্র্য
ডাইরেক্ট	ডাইরেক্ট
সহযোগীতা	সহযোগীতা
ঘূর্ণায়মান	ঘূর্ণা
জনপ্রিয়	প্রিয়
প্রমোদ	প্রমোদ
জামায়াতকে	জামায়াত
ফার্গুসন	ফার্গুসন
কবুতর	কবুতর
রডরিগো	রডরিগো
আকিরা	আকি
সর্বভারতীয়	সর্বভারত
ওয়াসাল্লামের	ওয়াসাল্লাম
কন্যাসন্তান	কন্যাসন্তান
ধর্মভীরু	ধর্ম
হিরন	হিরন
সংক্রান্তি	সংক্রান্ত
কূটনীতিকদের	নীতি
কাপড়ও	কাপড়
কাইফের	কাইফ
নগরবাসীর	নগরবাসী
ঘণ্টাখানেক	ঘণ্টা
ডেক্সটপ	ডেক্স
মঞ্চায়নের	মঞ্চ
অবস্থায়	অবস্থা
সৌভাগ্যবান	সৌভাগ্য
ব্লগারকে	ব্লগার
কান্নায়	কান্না
ইয়াং	ইয়াং
ভরের	ভর
শুশুক	শুশুক
দাঁড়াতে	দাঁড়
আত্মসংযম	আত্মসংযম
বিশ্বরেকর্ডের	বিশ্বরেকর্ড
দাসত্ব	দাস
নূরানী	নূরানী
এডমন্ড	এডমন্ড
নিম্নের	নিম্ন
টরোন্টো	টরোন্টো
অন্যায়ের	অন্যায়
মান্নানের	মান্নান
গ্রামাঞ্চল	গ্রামাঞ্চল
সভাপতির	সভা
ধকল	ধকল
পাপপূর	পাপ
ওয়ার্ল্ডের	ওয়ার্ল্ড
প্রেরিতদের	প্রেরিত
চিত্রিত	চিত্র
ফাটলের	ফাটল
ক্রীড়াঙ্গনের	ক্রীড়াঙ্গন
স্বজনের	স্বজন
ইটালি	ইটালি
নিত্য	নিত্য
দিনশেষে	দিন
নিক্তি	নিক্তি
তুইও	তুই
সাবধানতা	সাবধান
ভোগ্যপণ্য	ভোগ্যপণ্য
কাটা	কাট
স্থিতি	স্থিতি
মশিউর	মশিউর
বালাপাড়া	বালাপাড়া
কোর্টনি	কোর্ট
এতদিনে	দিন
কালী	কালী
হলিডে	হলিডে
পরিবেশবিষয়ক	পরিবেশ
আরডি	আরডি
মহর্ষি	মহর্ষি
জোরে	জোর
ইস্রায়েলি	ইস্রায়েল
লাইলা	লাইলা
বলবেন	বল
কাফেলার	কাফেলা
জায়গামত	জায়গা
শাহাজাহান	শাহাজাহান
হারা	হার
নিরসনে	নিরসন
শান্তিচুক্তি	শান্ত
পরস্পরে	পর
শাসনব্যবস্থায়	শাসন
সহিত	সহি
ভুয়া	ভুয়া
অধিকারের	অধিকার
বেল্ট	বেল্ট
মেয়েটির	মেয়ে
নামাবে	নামাব
সাতছড়ি	সাতছড়ি
কীবোর্ডের	কীবোর্ড
জনগোষ্ঠীতে	জনগোষ্ঠী
কেবলের	কেবল
লালপুর	লালপুর
অনাপত্তি	অনাপত্তি
বরখাস্তের	বরখাস্ত
মনিটর	মনিটর
নাইট	নাইট
নির্যাস	নির্য
মাদার	মাদার
প্রাণীদের	প্রাণী
অক্ষুণ্ন	ক্ষুণ্ন
নদীমাতৃক	নদী
ইউসুফী	ইউসুফ
চ্যাটার্জির	চ্যাটার্জি
নেচেছেন	নেচেছে
শিকলে	শিকল
ফাংশনকে	ফাংশন
মুড়ে	মুড়
ভোজে	ভোজ
বোধশক্তি	বোধ
ছাড়াছাড়ি	ছাড়াছাড়ি
জড়িয়েছিলেন	জড়িয়ে
সোলোনয়েড	সোলোনয়েড
পিঙ্ক	পিঙ্ক
ছেড়েছেন	ছেড়েছে
দেবেন্দ্রনাথ	দেবেন্দ্রনাথ
ফেরৎ	ফেরৎ
ক্লুনির	ক্লুনি
কবে	কবে
প্রয়োগ	প্রয়োগ
সতী	সতী
কয়জন	কয়জন
চণ্ডীদাস	চণ্ডীদাস
শোকাহত	শোক
আশ্রয়কেন্দ্রে	আশ্রয়কেন্দ্র
মোম	মোম
সোর্স	সোর্স
দৃষ্টিভঙ্গির	দৃষ্টি
রতিপন	রতিপন
অনুরক্ত	অনুরক্ত
তৎক্ষনাৎ	তৎক্ষনাৎ
ল্যাক্টাম	ল্যাক্টাম
পাঠিয়েছে	পাঠিয়ে
সাপ্তাহিক	সাপ্তাহ
কীরকম	রকম
পাহাড়ি	পাহাড়
ভয়াবহ	ভয়াবহ
খেয়ালী	খেয়াল
ডিলডো	ডিলডো
আইটিএস	আইটিএস
পুলিশদের	পুলিশ
লুমিয়া	লুমিয়া
লাঙলের	লাঙল
নারিকেলের	নারিকেল
দুর্গা	দুর্গা
ইসরায়েলিদের	ইসরায়েল
সাফায়েত	সাফায়েত
আয়ের	আয়
ইদ্রিস	ইদ্রিস
নেতাজির	নেতাজি
গ্যাবনের	গ্যাবন
আদমশুমারী	আদমশুমারী
শিষ্টাচারের	শিষ্টাচার
প্রতিষ্ঠানটিকে	প্রতিষ্ঠান
মাম্বা	মাম্বা
বায়ুসংক্রান্ত	বায়ু
চাহনিতে	চা
দাম্মাম	দাম্মাম
গুলিও	গুলি
বাগেরহাটে	বাগেরহাট
পিওএম	পিওএম
স্যরি	স্যরি
কল্পনাতেও	কল্পনা
শর্তহীন	শর্ত
অবস্থিত	অবস্থিত
টুং	টু
কাটাল	কাটাল
ওরেল	ওরেল
রিটে	রিট
দোভাষী	ভাষী
গ্রুপটির	গ্রুপ
ছুঁতে	ছুঁতে
পরাস্ত	পরাস্ত
হিউস্টনে	হিউস্টন
অবন্তী	অবন্তী
করিন্থীয়দের	করিন্থীয়
দ্রুতগতি	দ্রুত
দানিয়েল	দানিয়েল
অস্বস্তিকর	অস্বস্তি
স্থাপত্যকলার	স্থাপত্য
যিহুদি	হুদ
লেখাটি	লেখা
কাইয়ূম	কাইয়ূম
অসাবধানতাবশত	সাবধান
অনিমেষ	অনিমেষ
অনুষদের	ষদ
দেশটির	দেশ
আয়াত	আয়াত
মাসুমকে	মাসুম
রিতু	রিতু
একগুচ্ছ	এক
রাতটি	রাতটি
ল্যাবরেটরিতে	ল্যাবরেটরি
কৌঁসুলিদের	কৌঁসুল
লঙ্কানদের	লঙ্কা
রামুর	রামু
আবিষ্কার	আবিষ্কার
উপার্জিত	উপার্জিত
সৈন্যরা	সৈন্য
অলরাউন্ডারকে	অলরাউন্ডার
ব্রহ্মাস্ত্র	ব্রহ্মাস্ত্র
যেখানেই	যেখান
জ্যাজ	জ্যাজ
মালিকেরাও	মালিক
বার্কলে	বার্কল
হজযাত্রী	হজ
ভোটে	ভোট
স্তরে	স্তর
শ্রুত	শ্রুত
অসাধ্য	সাধ্য
বিপাশা	বিপাশা
অজন্তা	জন্তা
পেসমেকার	পেসমেকার
শারীরবিদ্যা	শারীর
ইনস্টল	ইনস্টল
বাদেই	বাদ
জিত	জিত
লেখালেন	লেখ
সংশ্লেষণের	সংশ্লেষণ
বন্টন	বন্টন
রূপগঞ্জে	রূপগঞ্জ
সিটিজেন	সিটিজেন
সূক্ষ্মভাবে	সূক্ষ্ম
ধোনির	ধোনি
এমারসন	এমারসন
ক্লিকের	ক্লিক
গবেষণালব্ধ	গবেষণা
সেক্রেটারির	সেক্রেটারি
নিরাপত্তারক্ষীরা	নিরাপত্তা
মিউনিসিপাল	মিউনিসিপাল
দশকেরও	দশক
গিবসন	গিবসন
শাকিরার	শাকিরা
গুলিবর্ষণের	গুলি
জিতা	জিত
শীতকালীন	শীত
গণশিক্ষামন্ত্রী	শিক্ষা
রাগমোচন	রাগ
নির্গত	নির্গত
রহস্যজনক	রহস্য
মোটরসাইকেলে	মোটরসাইকেল
মালা	মালা
তুরস্ক	তুরস্ক
বহুভুজের	বহুভুজ
ভবিষ্যদ্বাণীগুলো	ভবিষ্যদ্বাণীগুলো
কমিটিরও	কমিটি
গ্রাম	গ্রাম
মোহম্মদ	মোহম্মদ
নওশীন	নওশীন
পারাপারে	পারাপার
অমৃতা	মৃত
হরিণা	হরিণ
মনোজগতে	মনোজগত
লেন্ডল	লেন্ডল
লেক্স	লেক্স
উল্লাস	উল্লাস
বিশ্বরোড	বিশ্বরোড
বিভ্রাটের	বিভ্রাট
এলে	এল
চারিত্রিক	চারিত্রিক
এনিমেটেড	এনিমেট
আগ্রহী	গ্রহ
বোনাসের	বোনাসের
খ্রীস্টান	খ্রীস্টান
সালিমুল	সালিমুল
আইআইটি	আইআইটি
কাহাকে	কাহা
সংস্থাই	সংস্থা
লোকদেখানো	লোক
গ্রামগুলোতে	গ্রাম
আলুতে	আলু
রাজাখালী	রাজ
খেদ	খেদ
আলীর	আলী
লিডার	লিডার
অভিকর্ষজ	অভিকর্ষ
ইলেকট্রস্ট্যাটিক	ইলেকট্রস্ট্যাটিক
নাছিরকে	নাছির
হইয়াছে	হই
পিতৃভূমি	পিতৃ
মার্থা	মার্থা
জামাটা	জামা
কারসাজি	কারসাজি
পিএমএল	পিএমএল
বেকারত্বের	বেকারত্ব
অহিংস	অহিংস
ডাটাবেসে	ডাটাবেস
কসোভো	কসোভো
বংশদ্ভুত	বংশ
বিভাগও	বিভাগ
পাইন	পাইন
ফাইবারের	ফাইবার
মিথাইল	মিথাইল
মনোনয়নপ্রত্যাশী	মনোনয়ন
বাজনার	বাজনা
সাইট্রাস	সাইট্রাস
দলীয়করণের	দল
সদা	সদা
উইপোকা	উইপোকা
জঙ্গীরা	জঙ্গী
বিত্তবানদের	বিত্ত
ব্যর্থতাকে	ব্যর্থতা
মৌলভীবাজার	মৌলভীবাজার
ব্রাদার্সকে	ব্রাদার্স
রোতা	রোতা
সনদ	সনদ
হতেও	হত
দেখত	দেখ
বৌদ্ধ	বৌদ্ধ
আইসোপট্রপি	আইসোপট
আকাশযান	আকাশযান
নিজাম	নিজাম
অবসাদের	অবসাদ
কলকাতাসহ	কলকাতা
আইনই	আইন
সীমার	সীমা
উপসংহারে	উপসংহার
লুকানো	লুকা
বক্তৃতাদানের	বক্তৃতাদান
শহরাঞ্চলে	শহর
পৌঁছেছি	পৌঁছে
গ্রন্থগুলি	গ্রন্থ
খাদে	খাদ
মেরিল্যান্ডের	মেরিল্যান্ড
প্রতারণামূলক	প্রতারণা
গাজীউল	গাজীউল
ডায়ালগ	ডায়ালগ
মুকিত	মুকি
গোলাবর্ষণ	গোলা
সর্ম্পকে	সর্ম্পক
ইইজি	ইইজি
মৃতকে	মৃত
গণভবনে	গণভবন
কোয়ার্টার	কোয়ার্টার
উভয়ই	উভয়
হামযা	হামযা
রক্ষণশীল	রক্ষণ
বর্তনীর	বর্তনী
ইত্যাদির	ইত্যাদি
ট্র্যাজিক	ট্র্যাজিক
অন্যটি	অন্য
কুমড়ো	কুমড়ো
আদিম	আদিম
জ্যাসন	জ্যাসন
অফিসের	অফিস
অটোক্যাড	অটোক্যাড
মুহাম্মদ	মুহাম্মদ
হাড্ডাহাড্ডি	হাড্ডা
কার্ডিও	কার্ডিও
উপমন্ত্রী	মন্ত্রী
জলাবদ্ধতা	জল
ধাপের	ধাপ
রাষ্ট্রপ্রধানদের	রাষ্ট্র
ধরনটা	ধরন
খালাসে	খালাস
রুটটি	রুট
কিলোবাইট	কিলোবাইট
আলিকে	আলি
গোপনীয়	গোপন
পেরেইরা	পেরেইরা
অনিচ্ছার	অনিচ্ছা
কান্ডারি	কান্ডার
প্রভিশন	প্রভিশন
ইরেশ	ইরেশ
বিষয়বস্তুতে	বিষয়
নিমা	নিমা
চেকলিস্ট	চেকলিস্ট
হেফাজতকারী	হেফাজত
বেতনসহ	বেতন
শহরজুড়ে	শহর
হিমাগারে	হিম
বিতণ্ডায়	বিতণ্ডা
নীলকরদের	নীলকর
প্যাকেজ	প্যাকেজ
বেকেট	বেকেট
পাহারায়	পাহারা
দেশভাগ	দেশ
স্নাতকোত্তরের	স্নাতক
পান্ডিয়া	পান্ডিয়া
থমাসের	থমাস
হয়ে	হয়
ফার্সি	ফার্সি
অমঙ্গলের	মঙ্গল
পোল্যান্ড	পোল্যান্ড
ভাগনি	ভাগনি
নন্দিত	নন্দিত
সমাদ্দার	সমাদ্দার
শিহরিত	শিহরিত
হত্যাকাণ্ডে	হত্যাকাণ্ড
শেষদিক	শেষদিক
শৃঙ্খলাবদ্ধ	শৃঙ্খল
রাস্তাঘাট	রাস্তাঘাট
দফতর	দফতর
সুবিধে	সুবিধে
নাভানা	নাভানা
ফিনিস	ফিনিস
বিএফবিএস	বিএফবিএস
তালাক	তালাক
অধিনে	অধিন
আসাতে	আসাতে
ইনসাফ	ইনসাফ
বাজপেয়ির	বাজপেয়ি
ট্রেইল	ট্রেইল
শুনতেও	শুন
শিরো	শির
সমতাপীয়	সমতাপ
এলডিসি	এলডিসি
মধ্যেকার	মধ্য
পুঁথিতে	পুঁথি
উঠিয়ে	উঠ
ভিয়েনা	ভিয়েনা
নিষ্প্রাণ	নিষ্প্রাণ
তোমায়	তোমায়
এফসিপিএস	এফসিপিএস
দফায়	দফা
এমওপি	এমওপি
লিয়াং	লিয়াং
বয়ফ্রেন্ড	বয়ফ্রেন্ড
পতনশীল	পতন
অ্যানিম্যাল	অ্যানিম্যাল
মেয়েশিশুদের	মেয়ে
হতাশার	হতাশ
প্রদীপ	দীপ
শামীমুল	শামীমুল
ইকোনমিস্ট	ইকোনমিস্ট
তেহরানের	তেহরান
এতোই	এতো
নভোচারী	নভোচারী
শ্রেণিবিন্যাস	শ্রেণি
রক্ষাকবচ	রক্ষা
চরিত্রই	চরিত্র
হিরোশিমার	হিরোশিমা
কবিতায়	কবিতা
হাসন	হাসন
যাচ্ছিস	যাচ্ছি
খাইবার	খাইবার
কোণে	কোণ
ধারাতেই	ধারাতে
কদমতলীর	কদমতলী
বাঁশখালীতে	বাঁশখালী
পরীক্ষায়	পরীক্ষা
পিয়ংইয়ংয়ের	পিয়ংইয়ং
অ্যান্ড্রয়েড	অ্যান্ড্রয়েড
শুষ্ক	শুষ্ক
মুড়ি	মুড়ি
অক্ষাংশের	অক্ষ
বিএসআরএম	বিএসআরএম
ফয়সালার	ফয়সালা
মুখরোচক	মুখ
মির্জাপুর	মির্জাপুর
আবৃত্তি	আবৃত্তি
বয়সী	বয়স
গোয়ালঘরে	গোয়ালঘর
ভাণ্ডারে	ভাণ্ডার
লড়াইরত	লড়াই
কাঁদি	কাঁদ
চিন্তাধারায়	চিন্তা
মোটরবাইক	মোটরবাইক
এলাকাগুলির	এলাকা
কুচকাওয়াজে	কুচকাওয়াজ
কবিকে	কবি
দ্রুততা	দ্রুত
হেরাথ	হেরাথ
শাসকের	শাসক
নিরাপদ	পদ
পেপারে	পেপার
চ্যালেঞ্জটি	চ্যালেঞ্জ
ইকার্দির	ইকার্দি
এক্সপনেনশিয়াল	এক্সপনেন
বুধবার	বুধ
অযথাই	অযথা
কিনারে	কিনার
পৃঃ	পৃঃ
জুড়ি	জুড়ি
প্রতিজ্ঞাবদ্ধ	প্রতিজ্ঞা
আদ্যোপান্ত	আদ্যোপান্ত
রত্নার	রত্না
কাঁচাবাজারের	কাঁচাবাজার
নানামুখী	নানামুখ
এক্তিয়ারভুক্ত	এক্তিয়ার
রোবোটিক	রোবোট
ম্যাটেরিয়াল	ম্যাটেরিয়াল
দিনগুলোকে	দিনগুলো
স্ক্রিপ্টিং	স্ক্রিপ্ট
সিন্ডিকেটে	সিন্ডিকেট
দেখি	দেখ
গায়িকার	গায়িকা
পোষ্যদের	পোষ্য
গমনার্থে	গমনার্থ
ইন্স্যুরেন্স	ইন্স্যুরেন্স
হাটবাজারে	বাজার
মিটারে	মিটার
শ্রমবাজারে	শ্রম
দোলনায়	দোলন
জমিয়েছিলেন	জমিয়েছ
পররাষ্ট্রসচিব	পররাষ্ট্র
হূদয়	হূদয়
টাওয়ারে	টাওয়ার
ক্ষেত্রফলের	ক্ষেত্রফল
নন্দ	নন্দ
বন্দ্যোপাধ্যায়কে	বন্দ্যোপাধ্যায়
ডেমি	ডেমি
মুক্তারপুর	মুক্তা
এইমস	এইম
প্রমুখের	প্রমুখ
সাত	সাত
রয়্যালটি	রয়্যাল
চক্রাকার	চক্র
নাট্যকর্মীদের	নাট্যকর্মী
রিকি	রিকি
তরুন	তরুন
বিজ্ঞাপনচিত্র	বিজ্ঞাপন
আহরিত	আহ
মেহমেদ	মেহমেদ
স্ব	স্ব
শাসকদের	শাসক
উপকারভোগীদের	উপকার
বৃৃদ্ধির	বৃৃদ্ধি
ডেলা	ডেলা
একভাগ	একভাগ
সিধু	সিধু
স্টিমারে	স্টিমার
ধারক	ধারক
গাঁট	গাঁট
দেখাচ্ছ	দেখাচ্ছ
অন্ত্যেষ্টিক্রিয়ার	ক্রিয়া
মর্মে	মর্ম
মাউস	মাউস
দয়া	দয়া
সূত্রপাতের	সূত্রপাত
বাদ্যযন্ত্র	বাদ্যযন্ত্র
বর্ণনির্বিশেষে	বর্ণনির্বিশেষ
কেরোসিনের	কেরোসিন
সুদক্ষ	দক্ষ
ইলেভেনের	ইলেভেন
আলোচনায়	আলোচনায
দর্শনার্থীরা	দর্শনার্থী
বীরভূমের	বীরভূম
সন্ধিক্ষণ	সন্ধিক্ষণ
বেড়ায়	বেড়া
বিবৃতিতে	বিবৃতি
সংক্ষিপ্তকালের	সংক্ষিপ্তকাল
লেস্টার	লেস্টার
রিংকি	রিংকি
পড়াটা	পড়া
যৌতুক	যৌতুক
লিটু	লিটু
গতিপথের	গতি
লটের	লট
শেষেও	শেষ
শিল্পায়ন	শিল্প
লাগসই	লাগস
রাচীরের	রাচীর
অ্যাড	অ্যাড
স্মার্টফোনটিতে	স্মার্টফোন
এনডিপি	এনডিপি
শ্রমজীবী	শ্রম
বেড়াল	বেড়া
কাঁদতে	কাঁদ
অবিরতভাবে	বিরত
আমেন	আমেন
বাসর	বাসর
ভার্গাস	ভার্গাস
ট্রিবিউন	ট্রিবিউন
দুঃখ	দুঃখ
ফিনান্স	ফিনান্স
হিসাবরক্ষক	হিসাব
নান্টু	নান্টু
অগ্রপথিক	অগ্র
রুলেট	রুলেট
ভূত	ভূত
গ্রিনকার্ড	গ্রিন
বাস্তবায়ন	বাস্তব
মিটারেরও	মিটার
ডিফেন্ডারের	ডিফেন্ডার
মেক	মেক
ভুলই	ভুল
আর্থারের	আর্থার
খাইয়ে	খা
নাথন	নাথ
ক্যি	ক্য
মরোক্কোতে	মরোক্কো
লন্ডনে	লন্ডন
উপপাদনের	উপপাদন
এজেন্টস	এজেন্ট
হচ্ছো	হচ্ছ
তনুশ্রী	তনুশ্রী
সবকিছুরই	সবকিছু
পতঙ্গ	পতঙ্গ
এমনিভাবে	এমন
মীরাক্কেল	মীরাক্কেল
সায়েন্সের	সায়েন্স
পরিচালকসহ	পরিচালক
রহমতের	রহমত
সেকশন	সেকশন
পিএম	পিএম
অর্থই	অর্থ
সুপারিশও	সুপারিশ
দিনগুলোতে	দিন
একরকমের	এক
দেশান্তরি	দেশ
টরন্টোয়	টরন্টো
অপটিকাল	অপটিকাল
সমমনা	সমমন
মিশরে	মিশর
ট্যাক্সের	ট্যাক্স
শ্রমিকদের	শ্রমিক
প্রোপেন	প্রোপেন
অত্যাচারে	অত্যাচার
রেজিমেন্টের	রেজিমেন্ট
এডিপি	এডিপি
গ্রিজমানের	গ্রিজমান
ব্যয়বহুল	ব্যয়বহুল
অভুক্ত	অভুক্ত
প্রোগ্রামের	প্রোগ্রাম
উত্তরাঞ্চলের	উত্তরাঞ্চল
ইন্টারসিটি	সিটি
খরগোশ	খরগোশ
ইজরায়েলকে	ইজরায়েল
কাজীপাড়া	কাজী
নরওয়েজিয়ান	নরওয়ে
শোরুম	শোরুম
কোদালিয়া	কোদাল
গার্ডার	গার্ডার
নবীনগরে	নবীনগর
সমাজব্যবস্থায়	সমাজ
নটর	নটর
টাকাকে	টাকা
এমটিএ	এমটি
যাওয়ারই	যাওয়া
ময়রা	ময়রা
চিপস	চিপস
বাসস্ট্যান্ডে	বাসস্ট্যান্ড
সাহেল	সাহেল
জীবনসংগ্রাম	জীবন
মুহাম্মাদের	মুহাম্মাদ
মূর্ছা	মূর্ছা
রোজিনার	রোজিনা
ষেই	ষেই
ঝুমা	ঝুমা
অসংখ্যবার	অসংখ্য
ক্লিনটন	ক্লিনটন
বোঝায়	বোঝা
বেলুনের	বেলুন
তাঁতিরা	তাঁতি
ক্যামেরুন	ক্যামেরুন
ক্যালেন্ডারের	ক্যালেন্ডার
চালাকি	চালাকি
প্রশাসনে	প্রশাসন
সিলেট	সিলেট
ঘরগুলোতে	ঘর
ইনিংসটিতে	ইনিংস
ইউরি	ইউরি
প্রতিযোগিতায়	প্রতিযোগিতা
নর্তকী	নর্তকী
পরিণয়	পরিণয়
প্রসবকালীন	প্রসব
পিসিবির	পিসিবি
ইন্টারপ্রিটেশন	ইন্টারপ্রিট
সৌধ	সৌধ
মদ্যপ	মদ্য
সিনিয়র	সিনিয়র
আহমেদনগর	আহমেদনগর
ইঞ্জিনটি	ইঞ্জিন
বিতণ্ডা	বিতণ্ডা
চিহ্নিতকরণ	চিহ্নিত
দিলেও	দিল
ব্যবহারকে	ব্যবহার
খুনিরা	খুনি
ব্যাপারটিও	ব্যাপার
খেদা	খেদা
ক্বিয়ামত	ক্বিয়ামত
তিউনিশিয়া	তিউনিশিয়া
জিতি	জিত
পর্বগুলো	পর্ব
ঘানার	ঘানা
দখিন	দখিন
বায়োমেট্রিক	বায়োমেট্রিক
রবার্তো	রবার্তো
হরিপদ	হরিপদ
উদ্বোধক	উদ্বোধক
বাংকারে	বাংকার
চামড়াশিল্প	শিল্প
আনাস	আনাস
গামলা	গামলা
পরিমাণই	পরিমাণ
জুলুম	জুলুম
হরিশচন্দ্র	হরিশ
লতি	লতি
হোস্টেলের	হোস্টেল
বংশবিস্তার	বংশ
এবারকার	এবার
কেজরিওয়াল	কেজরিওয়াল
রঞ্জনবিদ্যা	রঞ্জন
দাবীদার	দাবী
এনিমি	এনিমি
মোদী	মোদী
মধ্যচ্ছদা	মধ্য
গেটাফের	গেটাফের
মেকানিক্স	মেকানিক্স
ধ্বংসাবশেষ	ধ্বংস
সাহিত্যিকেরা	সাহিত্য
মঞ্জুরি	মঞ্জুরি
কামিন্সের	কামিন্স
রাজিউদ্দিন	রাজিউদ্দিন
এয়ারলাইনসের	এয়ারলাইনস
পৌরসভাসহ	সভা
ত্রিভুজের	ত্রিভুজ
কখনো	কখন
স্বতঃস্ফূর্ত	স্ফূর্ত
তাঁবু	তাঁবু
মধ্যপ্রদেশে	মধ্যপ্রদেশ
পলিমাটি	পলিমাটি
সতর্কভাবে	সতর্ক
ব্যাংকিংয়ে	ব্যাংক
গুরুত্বপূর্ণ	গুরুত্ব
ছিট	ছিট
গ্রীনহাউস	গ্রীনহাউস
সঙ্গেই	সঙ্গ
চড়ে	চড়
জলাধারের	জলাধার
গফুরের	গফুর
ওয়ার্কশপের	ওয়ার্কশপ
বৃক্ষরাজি	বৃক্ষ
ব্রেইনগুলোর	ব্রেইন
টিভিতে	টিভি
গরীব	গরীব
তাতারস্তানের	তাতারস্তান
উপসম্পাদকীয়	উপসম্পাদক
রেনবো	রেনবো
পৃথিবী	পৃথিবী
মিশেলে	মিশেল
অর্ধেকই	অর্ধেক
এদিকেও	এদিক
দ্বীপগুলি	দ্বীপ
তাম্রশাসনে	তাম্র
নৃত্যনাট্যের	নৃত্য
কূক	কূক
মোটিভ	মোটিভ
প্লাম্বিং	প্লাম্বিং
ড্রোনটি	ড্রোন
অব্যবস্থাপনার	অব্যবস্থাপনা
রক্ষণাত্মক	রক্ষণাত্মক
জিতেছিলাম	জিত
পরির	পরি
আহনাফ	আহনাফ
সফরেই	সফর
আবুলের	আবুল
স্কলাস্টিকা	স্কলাস্টিকা
অয়ন	অয়ন
জামরুল	জামরুল
মিলবে	মিল
কাশির	কাশি
ব্রাশলেস	ব্রাশলেস
বরদের	বর
বোথামের	বোথাম
ঝালাপালা	ঝালাপালা
সেইমতো	মতো
প্যালেসের	প্যালেস
অরিত্র	অরিত্র
কসোভোর	কসোভো
মালাগাসি	মালাগাসি
সমূলে	সমূল
দুটিও	দুটি
বরফ	বরফ
কাউকেই	কাউকে
নিয়ন্ত্রনে	নিয়ন্ত্রন
মুসলিমকে	মুসলিম
নাহি	নাহি
ঠেকে	ঠেকে
ভুক্তভোগীর	ভোগ
প্রিভিউ	প্রিভিউ
তাৎক্ষণিকভাবে	তাৎক্ষণিক
বসনিয়ান	বসনিয়া
আরভিং	আরভিং
নবায়নযোগ্য	নবায়ন
মাছগুলো	মাছগুলো
অন্যান্য	অন্য
অর্ধেকও	অর্ধেক
বাগধারা	বাগধারা
দৃঢ়পদ	দৃঢ়
মৌনতা	মৌন
লোককে	লোক
চিত্রকর্ম	চিত্র
কুকুরটির	কুকুর
ক্ষারের	ক্ষার
এমভি	এমভি
দারিয়াপুর	দারিয়া
বাথরুমের	বাথরুম
বীরেন্দ্র	বীরেন্দ্র
অর্ণবপোত	অর্ণব
জাঙ্ক	জাঙ্ক
স্টিল	স্টিল
লিফটিং	লিফট
এইডসে	এইডস
কুরআনে	কুরআন
ফাইরুজ	ফাইরুজ
প্যাসকেল	প্যাসকেল
প্রতিরোধ	প্রতিরোধ
চলন	চলন
অভিযাত্রায়	যাত্রা
আইএসসি	আইএস
বিড়ালছানা	বিড়াল
দরজাটি	দরজা
অমানুষিক	মানুষ
সংকলিত	সংকলিত
মাড়ির	মাড়ি
কর্মকর্তাবৃন্দ	কর্মকর্তা
এরশাদও	এর
আশান্বিত	আশা
হলফনামার	হলফ
দুঃসাহসী	সাহস
জর্জিয়া	জর্জিয়া
শাস্ত্রকে	শাস্ত্র
অনুল্লেখ্য	অনুল্লেখ
সুভাষচন্দ্র	সুভাষচন্দ্র
কেজিবি	কেজিবি
হাজিরহাট	হাজিরহাট
সহশিল্পী	শিল্পী
আর্নেস্ট	আর্নেস্ট
কাঠাম	কাঠ
মীনাক্ষী	মীন
বাবুর্চি	বাবুর্চি
বিলিয়নের	বিলিয়ন
জঞ্জাল	জঞ্জাল
স্কিমার	স্কিমা
পঁচাত্তর	পঁচাত্তর
নদীতীর	নদী
দেখতো	দেখ
বুঝেও	বুঝ
ধারকের	ধারক
নীলে	নীল
ভাঙ্গনের	ভাঙ্গন
কায়রো	কায়রো
ধ্বনিতত্ত্ব	ধ্বনিতত্ত্ব
কাদাপানি	কাদাপানি
ওপেনারকে	ওপেনার
লোকে	লোক
ভুমির	ভুমি
প্রক্রিয়াটি	প্রক্রিয়া
পোস্টকার্ড	পোস্টকার্ড
নারীদেরকে	নারী
কুরাইশদের	কুরাইশ
জ্যাকেটের	জ্যাকেট
সন্ধ্যার	সন্ধ্যা
কেক	কেক
মামলায়ও	মামলা
শুনলে	শুন
আশ্রম	আশ্রম
চারুকলার	চারুকলা
উঠেন	উঠ
সিমুলেশনে	সিমুলেশন
পরিসংখ্যান	পরিসংখ্যা
খ্রিস্টপূর্বাব্দের	খ্রিস্টপূর্ব
সিনেমার	সিনেমা
টটেনহামের	টটেনহাম
ছায়াছবিটির	ছায়াছবিটি
আর্টের	আর্ট
স্নাতকে	স্নাতক
কঠোরতার	কঠোর
পারেন	পার
ফিলিপিন্স	ফিলিপিন্স
কলমাকান্দা	কলমা
আড়ম্বর	আড়ম্বর
হামিদকে	হামিদ
এনটিটি	এনটিটি
যায়নি	যায়
বন্ধে	বন্ধ
লাগছিল	লাগছিল
দায়মুক্তি	দায়মুক্তি
কুয়েতি	কুয়েত
উইম্যান	উইম্যান
ছুটেছেন	ছুটে
ওয়্যার্ড	ওয়্যার্ড
বিকেলে	বিকেল
ক্রসের	ক্রস
আখাউড়ার	আখাউড়া
প্রাণিবিদ্যা	প্রাণি
বোঝা	বোঝ
সাম্রাজ্যবাদের	সাম্রাজ্যবাদ
চাহিদাকে	চাহিদা
এসকোবার	এসকোবার
বেত্রাঘাত	বেত্রাঘাত
মুভ	মুভ
ফলকে	ফল
কাপালি	কাপালি
বাসদের	বাসদ
জটায়ু	জটা
খণ্ডটি	খণ্ড
সিএমএইচ	সিএমএইচ
শহরগুলি	শহর
গোধূলি	গোধূলি
বুদবুদ	বুদবুদ
আত্তার	আত্তার
দৌরাত্ম্যে	দৌরাত্ম্য
নির্যাতন	নির্যাতন
আগারগাঁওয়ে	আগারগাঁও
পূর্বশর্ত	পূর্বশর্ত
চ্যানেলগুলো	চ্যানেল
অপলক	লক
দূর্নীতি	দূর্নীতি
দোহায়	দোহা
টার্মিনেটর	টার্মিনেটর
কোয়ালকম	কোয়ালকম
গিলক্রিস্টের	গিলক্রিস্ট
দশদিন	দশ
মিলিটারির	মিলিটারি
তরতাজা	তাজা
তিনজন	তিন
আদেশই	আদেশ
সাইপ্রাস	সাইপ্রাস
বেইলী	বেইলী
সতর্ককারী	সতর্ক
গণ্ডিতে	গণ্ডি
যৌনবাহিত	যৌন
দিকটা	দিক
ত্রিমোহিনী	ত্রিমোহিনী
অতীশ	অতীশ
দেশনামা	দেশ
তরকারি	তরকারি
অজেয়	অজেয়
হওয়াতে	হওয়া
কৌতূহলোদ্দীপক	কৌতূহল
সুবিধামত	সুবিধা
খোলা	খোলা
ইউটা	ইউটা
কেটো	কেটো
ইন্টারকন্টিনেন্টাল	ইন্টারকন্টিনেন্টাল
ক্যালিফোর্নিয়ার	ক্যালিফোর্নিয়া
মসজিদকে	মসজিদ
মালয়েশিয়ায়	মালয়েশিয়া
কার্টেল	কার্টেল
জানিয়েছিলাম	জানিয়েছিল
লেখানো	লেখা
উদ্যমী	উদ্যম
বৈষম্যের	বৈষম্য
অ্যাটলেটিকো	অ্যাটলেটিকো
কুয়েতে	কুয়েত
আলোতেও	আলো
ধাবি	ধাবি
সাপোর্ট	সাপোর্ট
আহমদ	আহমদ
প্রিজমের	প্রিজম
জাপানে	জাপান
আকাঙ্খা	আকাঙ্খা
বেহালাবাদক	বেহালা
ঘটাতে	ঘট
কনফেডারেশনের	কনফেডারেশন
মানবীয়	মানব
সাক্ষ্যে	সাক্ষ্য
নিকটস্থ	নিকট
মাদকসেবীকে	মাদক
উত্তেজনায়	উত্তেজনা
নিউরোসার্জারি	নিউরোসার্জারি
জাবির	জাবির
কক্ষের	কক্ষ
দুলাল	দুলাল
পড়াশুনা	পড়া
ডলফিনের	ডলফিন
বহির	বহি
বস্তাবন্দী	বস্তাবন্দী
বালুচিস্তান	বালুচিস্তান
সাইয়িদ	সাইয়িদ
দাদাভাই	দাদাভাই
ব্লাঙ্ক	ব্লাঙ্ক
খাঁকে	খাঁক
পারি	পার
রাজকন্যার	রাজকন্যা
অধম	অধম
দাবাড়ু	দাবাড়ু
স্বজনপ্রীতি	স্বজন
পাঁচশো	পাঁচ
এরর	এরর
আইএসপি	আইএসপি
তুফানের	তুফান
বসানোর	বসা
ঝাঁজ	ঝাঁজ
লিবিয়ায়	লিবিয়া
চুম্বকত্ব	চুম্বক
ফেরেশতারা	ফেরেশতা
লাকি	লাকি
জেলহাজতে	জেলহাজত
গাজার	গাজা
খৈল	খৈল
মোকাবিলার	মোকাবিলা
গরিষ্ঠ	গরিষ্ঠ
রাগটা	রাগ
মিজ	মিজ
আতাউল	আতাউল
রেজওয়ান	রেজওয়ান
ক্রিকেটটা	ক্রিকেট
প্রতিবেশগত	প্রতিবেশ
মেগাবাইট	বাইট
মুন্নী	মুন্নী
হকও	হক
চাঞ্চল্যকর	চাঞ্চল্য
জিম্বাবুয়ের	জিম্বাবুয়ে
ভাষণটি	ভাষণ
ডিভিডেন্ড	ডিভিডেন্ড
লুত	লুত
ভাঙাতে	ভাঙা
অনুপ্রবিষ্ট	প্রবিষ্ট
বিবেচনাতেই	বিবেচনা
লাগিয়েছি	লাগিয়েছ
বিত্তবান	বিত্তবান
যিশু	যিশু
মুঈনুদ্দীন	মুঈনুদ্দীন
রোগনির্ণয়	রোগনির্ণয়
ওপারের	ওপার
যিশয়ের	যিশ
ভিড়িয়ে	ভিড়
এলসির	লস
বাহরাইনী	বাহরাইন
ষ্টেশনে	ষ্টেশন
কারণসমূহ	কারণ
ইন্ডাস্ট্রিজ	ইন্ডাস্ট্রি
রবারের	রবার
উদ্ভুত	উদ্ভুত
ক্রশ	ক্রশ
সাত্তারকে	সাত্তার
ইতোমধ্যে	ইতোমধ্য
থেক	থেক
আশীর্বাদগুলো	আশীর্বাদ
মহাপরিচালককে	মহাপরিচালক
হরিণাকুণ্ডু	হরিণ
জাপানিদের	জাপান
ধনঞ্জয়া	ধন
সঙ্গমে	সঙ্গম
স্টিকার	স্টিকার
চিহ্নই	চিহ্ন
অসম্ভাব্য	অসম্ভাব্য
আজহার	আজহার
কহিনুর	কহিনুর
আসতো	আসত
কোপানো	কোপানো
বোলাররা	বোলার
ক্ষেত্রগুলিতে	ক্ষেত্র
সুর্যের	সুর্য
পারমানেন্ট	পারমানেন্ট
দিদিকে	দিদি
সিমিওনের	সিমিওনে
কাধে	কাধ
সম্প্রসারণের	সম্প্রসারণ
পেশাজীবীদের	পেশাজীবী
ফটোর	ফটো
উপজেলাধীন	জেলা
সামির	সামি
ডিসিপ্লিন	ডিসিপ্লিন
খাতকে	খাত
সংখ্যার	সংখ্যা
খানার	খানা
বিএসসিসিএল	বিএসসিসিএল
ইরানি	ইরান
দোলা	দোলা
অ্যালায়েন্স	অ্যালায়েন্স
সৌদিতে	সৌদি
অ্যাঙ্গেল	অ্যাঙ্গেল
দিনরাত	দিনরাত
ক্ষুদ্রাতিক্ষুদ্র	ক্ষুদ্রাতিক্ষুদ্র
গুপ্তের	গুপ্ত
স্নেহপূর্ণ	স্নেহ
কামড়ানো	কামড়
কাজকর্মকে	কাজ
স্টেশনগুলি	স্টেশন
পকেট	পকেট
নিধি	নিধি
রেশমী	রেশমী
গরিলা	গরিলা
ওখানকার	ওখান
শক্তিগুলোকে	শক্তি
বহরে	বহর
শাসনামলের	শাসন
কোনপ্রকার	কোনপ্রকার
শার্ক	শার্ক
ভোরের	ভোর
ভট্টশালী	ভট্টশালী
দর্শনের	দর্শন
কব্জিতে	কব্জি
শহরবাসী	শহর
গুরুভার	গুরুভার
অধি	অধি
ভিক্ষার	ভিক্ষা
গ্রামগুলির	গ্রাম
স্যামুয়েল	স্যামুয়েল
তৎপর	তৎপর
চেরোকি	চেরোকি
ক্রেজি	ক্রেজি
মালায়ালাম	মালায়ালাম
স্যাম্পলিং	স্যাম্পলিং
সুজানগর	সুজানগর
প্যাকিংয়ের	প্যাকিং
ইনিংসটা	ইনিংস
ফলাফলগুলি	ফলাফল
জুলে	জুল
মুখাবয়ব	মুখ
খিলান	খিলান
পর্বটা	পর্ব
ভিনেগার	ভিনেগার
দশকে	দশ
রোগকে	রোগ
পূর্ণিয়া	পূর্ণিয়া
শোকের	শোক
দলিলপত্র	দলিল
নাদিম	নাদিম
ম্যানুয়াল	ম্যানুয়াল
জনপ্রিয়তাকে	জনপ্রিয়তা
তথাকার	তথাকার
দাক্ষিণাত্যে	দাক্ষিণ
স্ট্রাগল	স্ট্রাগল
মহাপরিদর্শকের	মহাপরিদর্শক
ওসমানী	ওসমানী
লিনাক্সে	লিনাক্স
সংখ্যাসমূহের	সংখ্যা
নড়চড়	নড়চড়
ভোলাগঞ্জ	ভোলাগঞ্জ
বলেছিলি	বলেছিল
চোকান	কান
গ্লু	গ্লু
জনবলের	জনবল
উচ্চপর্যায়	উচ্চপর্যায়
ডুয়িং	ডুয়িং
মুম্বাইতে	মুম্বাই
মিল্কি	মিল্কি
কার্ডধারী	কার্ড
ভরদুপুরে	দুপুর
ঠিকাদার	ঠিকাদার
আর্টিফিশিয়াল	আর্টিফিশিয়াল
আওয়াজ	আওয়াজ
জনযুদ্ধ	জনযুদ্ধ
পশ্চিমাঞ্চলীয়	পশ্চিমাঞ্চল
শাহিনকে	শাহিন
সমবায়ে	সমবায়
ছাড়াল	ছাড়া
ফিলিপাইনে	ফিলিপাইন
স্বয়ংক্রিয়ভাবেই	স্বয়ং
মন্তব্যে	মন্তব্য
খামের	খাম
পাটাতনের	পাটাতন
অনুভূতিতে	অনুভূতি
বহুমুখীকরণ	বহুমুখী
শিবির	শিবির
মেয়রদের	মেয়র
গৌরবজনক	গৌরব
হেনটাই	হেনটাই
চক্রাকারে	চক্রাকার
কোচিংয়ে	কোচিং
অথবা	অথবা
সিদ্ধান্তহীনতা	সিদ্ধান্ত
লিফটের	লিফট
তারিখগুলি	তারিখ
কারনেই	কারন
কলেজপড়ুয়া	কলেজ
ইন্টেলিজেন্সের	ইন্টেলিজেন্স
সম্প্রদায়গত	সম্প্রদায়
ক্রমবিকাশ	ক্রম
ওজোন	ওজোন
অধীন	অধীন
তথ্যকে	তথ্য
লালখান	লাল
জাতীয়	জাত
পরিবেষ্টনের	পরিবেষ্টন
নিয়ে	নিয়ে
নামকরণ	নাম
আনন্দে	আনন্দ
জেনিরোতে	জেনিরো
কোনোরকম	রকম
ঘটি	ঘটি
কাঁদার	কাঁদ
সীমা	সীমা
বায়ুচাপ	বায়ু
আত্মকেন্দ্রিক	আত্মকেন্দ্রিক
বৃষ্টিতেই	বৃষ্টি
ইনভেস্টমেন্টসের	ইনভেস্টমেন্ট
পর্যবেক্ষণটিই	পর্যবেক্ষণ
গ্রামটিকে	গ্রাম
চবিবশ	চবিবশ
ছিদ	ছিদ
আলট্রা	আলট্রা
এলাহাবাদে	এলাহাবাদ
সুমাইয়া	সুমাইয়া
উইকিবই	উইকিবই
গোনার	গোনা
ফার্মাসিউটিক্যাল	ফার্মাসিউটিক্যাল
গির্জাগুলো	গির্জা
বীজ	বীজ
দেশবিরোধী	দেশ
ফিল্মফেয়ার	ফিল্ম
রাশা	রাশা
আলোতে	আলো
খেলছি	খেল
ঋষিকেশ	ঋষিকেশ
যুবসংঘ	যুব
অনুভুতির	অনুভুতি
শহরাঞ্চলের	শহর
সিএএস	সিএএস
রেমো	রেমো
ফুসফুস	ফুসফুস
মাথাচাড়া	মাথা
পূর্বরূপ	রূপ
শপের	শপ
ভবিষ্যতের	ভবিষ্যত
তমার	তমা
খরচসহ	খরচ
অমলের	অমল
মামুনুলের	মামুনুল
মরিচগুঁড়া	মরিচগুঁড়া
অক্সাইড	অক্সাইড
খালেদার	খালেদ
সেনানায়ক	সেনানায়ক
ইয়াসিনের	ইয়াসিন
বিষক্রিয়া	বিষ
অযোগ্যতার	যোগ্যতা
খুনিকে	খুনি
ত্রিঘাত	ঘাত
মার্টি	মার্টি
হিত	হিত
বেবিট্যাক্সি	ট্যাক্সি
আসছিলো	আসছি
পাখা	পাখা
দুপুরেই	দুপুর
কোরিয়ান	কোরিয়া
এপ্রিলের	এপ্রিল
রহস্যময়	রহস্য
জড়	জড়
অধিগৃহীত	গৃহীত
প্রথমার্ধে	প্রথম
এভার	এভার
বিভিন্ন	বিভিন্ন
খিল	খিল
অনগ্রসর	অনগ্রসর
বার্কলি	বার্কলি
এসেছিলে	এসেছিল
ইমামুল	ইমামুল
ভলান্টিয়ার	ভলান্টিয়ার
সোনারায়	সোনা
কম্পিউটারকে	কম্পিউটার
উজ্জ্বলতর	উজ্জ্বল
নজরদারির	নজরদারি
ভীরুতা	ভীরুতা
কার্ডিফের	কার্ডিফ
অক্ষীয়	অক্ষ
প্রতিষ্ঠানগুলোও	প্রতিষ্ঠান
মুন	মুন
সামাজিক	সামাজিক
গোড়ালি	গোড়ালি
নীতিতে	নীতি
বাস্কেট	বাস্কেট
মান	মান
শুট	শুট
রেশমার	রেশমা
হাইতির	হাইতির
তামিম	তামিম
সৃষ্টিই	সৃষ্টি
মীরার	মীরা
বিবাহের	বিবাহ
যবস	যবস
কথাতেই	কথা
সৌদির	সৌদি
উদোম	উদোম
অ্যালবামটিতে	অ্যালবাম
বর্ধিতাংশ	বর্ধিতাংশ
পদ্মভূষণ	পদ্মভূষণ
বিটিভিতে	বিটিভি
এলাকাজুড়ে	এলাকা
ফুটেজ	ফুটেজ
ছেলেবেলার	ছেলেবেলা
পার্কিনস	পার্কিনস
ঘনিষ্ঠজন	ঘনিষ্ঠ
হাঁফ	হাঁফ
ভুলত্রুটি	ভুল
রিচার্ডসনের	রিচার্ডসন
বিল্ডিং	বিল্ডিং
ব্যাপারটা	ব্যাপার
সেনাসদস্যরা	সেনা
উহু	উহু
হবা	হবা
আয়মান	আয়মান
ওয়াশার	ওয়াশা
জেনেছিলেন	জেনেছিল
শিখরের	শিখর
অধ্যক্ষদের	অধ্যক্ষ
হাঁ	হাঁ
শোলে	শোল
সন্তানসন্ততি	সন্তান
আকাশের	আকাশ
শ্রিংলা	শ্রিংলা
লেনদেনও	লেনদেন
আয়নায়	আয়না
পর্যবেক্ষণকৃত	পর্যবেক্ষণ
প্রপঞ্চ	প্রপঞ্চ
অনুষ্ঠানগুলোর	অনুষ্ঠান
চেরি	চেরি
প্রনয়ন	প্রনয়
হোয়াট	হোয়াট
দিনটিকে	দিন
আগস্টের	আগস্ট
নায়িকাকে	নায়িকা
করজোড়ে	জোড়
আরামের	আরাম
কুইন	কুইন
গিগাবাইটের	বাইট
ইনভার্টেড	ইনভার্ট
কোস্টার	কোস্ট
অবধারণ	অবধারণ
নারকেলের	নারকেল
রিংয়ের	রিং
অভাবটা	অভাব
কমলনগর	কমলনগর
একাদশতম	এক
জানিয়েছিল	জান
মাওলা	মাওলা
ধরাবাঁধা	ধরা
উদ্বোধনের	উদ্বোধন
নারীনা	নারী
জাফলং	জাফলং
এজের	এজ
মেজো	মেজো
স্থানটির	স্থান
নামাঙ্কিত	নাম
ছাত্রসংখ্যা	ছাত্র
দাপুটে	দাপুট
মুরালিধরন	মুরালিধরন
মওলানা	মওলানা
নীতিনিষ্ঠার	নীতিনিষ্ঠা
ভ্রাম্যমাণ	ভ্রাম্য
শব্দটিই	শব্দ
গালিব	গালিব
এরপরের	এরপর
ব্যাকটেরিয়া	ব্যাকটেরিয়া
কাপর	কাপর
প্রিন্সে	প্রিন্স
পাগড়ি	পাগড়ি
পৃষ্ঠীয়	পৃষ্ঠ
হেকমত	হেকমত
সাতজনকে	সাতজন
আন্দোলনের	আন্দোলন
গান্ধীজি	গান্ধী
ল্যাটিন	ল্যাটিন
ডিহাইড্রেশন	ডিহাইড্রেশন
অধ্যাদেশে	অধ্যাদেশ
উদ্দেশ্যগুলো	উদ্দেশ্য
ফার্মগেটে	ফার্মগেট
আগ্রহই	আগ্রহ
কেরালার	কেরালা
পাবলিকের	পাবলিক
আগুয়েরো	আগুয়েরো
বিশ্বস্বাস্থ্য	বিশ্বস্বাস্থ্য
প্রশ্নগুলোর	প্রশ্নগুলো
ফ্রেড্রিক	ফ্রেড্রিক
জাতিসংঘে	সংঘ
হাবিজাবি	হাবিজাবি
হয়ও	হয়
ঋণগ্রহীতাদের	ঋণগ্রহীতা
ইনকিউবেটর	ইনকিউবেটর
ধাপটি	ধাপ
কাউন্টি	কাউন্টি
ক্রীড়াবিদের	ক্রীড়া
ভূগোলবিদ	ভূগোল
প্রভার	প্রভা
ডায়েটের	ডায়েট
গুনফল	গুনফল
ইউনিভার্স	ইউনিভার্স
নির্যাতিত	নির্যাতিত
রক্তে	রক্ত
টেষ্ট	টেষ্ট
চাঙ্গ	চা
রাশেদুল	রাশেদুল
রিগস	রিগস
বিপর্যয়	পর্য
অনুষ্ঠানগুলিতে	অনুষ্ঠান
বিষয়সম্পত্তি	সম্পত্তি
রিয়াদকে	রিয়াদ
কোনাকুনি	কোনাকুনি
অটিস্টিক	অটিস্টিক
বিক্রয়োত্তর	বিক্রয়
উদ্যোগও	উদ্যোগ
সিং	সিং
শুদ্ধাচার	শুদ্ধ
প্রমোশন	প্রমোশন
বাণীবাহক	বাণী
সুবাসিত	সুবাস
সহযোগে	সহযোগ
তহুরার	তহুরা
পালটা	পালটা
সাড়া	সাড়া
চেয়ে	চেয়ে
স্বল্পকালীন	স্বল্প
জামিলা	জামিলা
বিবৃতির	বিবৃতি
কপট	কপট
অবকাশ	অবকাশ
ফিল্ডার	ফিল্ড
পরিচয়ে	পরিচয়
আরটিভিতে	আরটিভি
পোহাচ্ছে	পোহাচ্ছে
বাধা	বাধ
অনুষ্ঠানমালার	অনুষ্ঠান
কোনো	কোন
ত্বকের	ত্বক
শ্লেষ্মা	শ্লেষ্মা
পোলার্ডের	পোলার্ড
নিয়েছি	নিয়েছ
অ্যালোন	অ্যালোন
আইনগুলোর	আইন
বিউটির	বিউটি
আবিষ্কারের	আবিষ্কার
কাত	কাত
টারটুলিয়ান	টারটুলিয়া
সাজেদুল	সাজেদুল
অপ্রদর্শিত	প্রদর্শিত
মধ্যমেয়াদি	মধ্যমেয়াদ
মমতার	মমতা
কোম্পানিকে	কোম্পান
নির্বাপণ	নির্বাপণ
আসামের	আসাম
কন্ডাক্ট	কন্ডাক্ট
একদিনেই	দিন
অভয়	অভয়
শ্যামাঘাস	শ্যামা
চালানোয়	চালানো
অশূর	অশূর
চাষবাস	চাষ
প্রকাশ	প্রকাশ
ততক্ষণে	ততক্ষণ
চপার	চপার
কলেজছাত্রের	কলেজ
অভিযাত্রা	অভিযাত্রা
এনএলডি	এনএলডি
গুরের	গুর
কমিয়ে	কম
পিস্তলসহ	পিস্তল
প্রস্তুতকারী	প্রস্তুত
লুকিয়ে	লুকিয়ে
রশিদুল	রশিদ
অভ্যুত্থানের	অভ্যুত্থান
জিনগত	জিন
সবসময়ের	সবসময়
সিপিসি	সিপিসি
ফতেহ	ফতেহ
ইতির	ইতি
পাঙাশ	পাঙাশ
নৈতিকতার	নৈতিকতা
তরঙ্গায়িত	তরঙ্গ
গাইবান্ধায়	গাইবান্ধা
আনাই	আনা
চিহ্নকে	চিহ্ন
গোলক	গোলক
চমকপ্রদ	চমকপ্রদ
কালশিটে	কাল
এয়ারলাইন্সের	এয়ারলাইন্স
ধর্মসম্প্রদায়	ধর্ম
কেও	কেও
কমনওয়েলথভুক্ত	কমনওয়েলথ
জানাচ্ছে	জানা
পগবা	পগবা
যুবতীরা	যুবতী
মানুষেরাই	মানুষ
অবস্থাদৃষ্টে	অবস্থা
মেয়াদোত্তীর্ণ	মেয়াদ
অংশটা	অংশ
পরিচালনায়	পরিচালন
দুইটিমাত্র	দুই
পূর্বদিকের	দিক
লেফট্যানেন্ট	লেফট্যানেন্ট
সাহাবুদ্দীন	সাহাবুদ্দীন
ওকলাহোমা	ওকলাহোমা
ইরানিদের	ইরান
তাক	তাক
জিরকোনিয়া	জিরকোনিয়া
অ্যাওয়ে	অ্যাওয়ে
ফলানো	ফলানো
পরায়	পরা
বালোতেল্লি	বালোতেল্লি
ক্ষমতাশীল	ক্ষমতা
আরোহী	আরোহ
গুঁতো	গুঁতো
ছাতা	ছাতা
মধ্যস্থিত	মধ্যস্থিত
অ্যাসবেস্টস	অ্যাসবেস্টস
যার	যার
নিত্যদিনের	দিন
মুম্বাই	মুম্বাই
মঙ্গোলিয়া	মঙ্গোলিয়া
রোহিতের	রোহিত
পারছিলেন	পারছিল
অনুবর	অনুবর
বিচারপতি	চার
সেকান্দার	সেকান্দার
পলিটব্যুরো	ব্যুরো
অ্যানি	অ্যানি
ব্যবসায়িক	ব্যবসা
উৎসবগুলো	উৎসব
ইব্রাহীমের	ইব্রাহীম
মারজিনাল	মারজিন
সিদ্দিকী	সিদ্দিকী
বাদশাহকে	বাদশাহ
ড্যামেজ	ড্যামেজ
বিপুলের	বিপুল
শিক্ষাপ্রতিষ্ঠানকে	শিক্ষা
জনসংখ্যার	জন
ছুরির	ছুরি
ডেসমন্ড	ডেসমন্ড
দাগযুক্ত	দাগ
সাইফন	সাইফন
প্রতিষ্ঠার	প্রতিষ্ঠা
বেগুনে	বেগুন
ভবিষ্যদ্বানী	বিষ
রিফ্লেকশন	রিফ্লেকশন
ব্ল্যাঙ্ক	ব্ল্যাঙ্ক
কীগুলি	কী
ধমকে	ধমক
অভিনয়	অভিনয়
যোগ্যতায়	যোগ্য
বশিরুল	বশিরুল
গ্রাহকেরা	গ্রাহক
সবসময়ই	সময়
ইজারার	ইজার
উদ্যোগের	উদ্যোগ
বুঝলেন	বুঝ
বাঁধের	বাঁধ
স্কিনস	স্কিন
সরকার	সরকার
তাপমাত্রাকে	তাপমাত্রা
আমাক	আমাক
শ্রবণ	শ্রবণ
ঘটনাই	ঘটন
প্লাগ	প্লাগ
তাহমিদ	তাহমিদ
সঞ্জয়	সঞ্জয়
হেট	হেট
জেনেটিক্স	জেনেটিক
বস্তুগুলোর	বস্তু
ছৈয়দ	ছৈয়দ
কুড়িয়েছেন	কুড়িয়ে
আফসানার	আফসানা
সদ্যোজাত	সদ্যোজাত
অর্থসহায়তা	অর্থ
মুসলমানগণ	মুসলমান
অগ্রাহ্য	গ্রাহ্য
অংশীদারত্বে	অংশীদারত
ইতিহাসবিদরা	ইতিহাসবিদ
দেখাব	দেখা
ডক্টরেট	ডক্টরেট
বিধৃত	বিধৃত
উদারনৈতিক	উদারনৈতিক
সগর্বে	গর্ব
দুটিই	দুটি
পৃথ্বী	পৃথ্বী
ডেকেছি	ডেকেছ
ডানায়	ডানা
ধ্ব	ধ্ব
জাওয়াহিরির	জাওয়াহিরি
বিচারপ্রার্থীদের	বিচার
সুমাইয়াকে	সুমাইয়া
নরওয়ে	নর
অনুরাগীদের	অনুরাগ
ফৌজি	ফৌজি
শুল্কমুক্ত	শুল্ক
অলংকারে	অলংকার
শ্বাসকষ্টে	শ্বাস
ফ্লাট	ফ্লাট
থাপড়	থাপড়
কর্ণাটকের	কর্ণাটক
চৌধুরানী	চৌধুরানী
ইনিয়েস্তা	ইনিয়েস্তা
থাবার	থাবা
ফুটবলপ্রেমীদের	ফুটবল
হ্যাডলির	হ্যাডলি
বামন	বামন
বিচারপতিরা	বিচার
পথনির্দেশক	পথ
বিষয়সমূহ	বিষয়
কবিতাটা	কবিতা
মিচ	মিচ
দিনসকাল	দিন
গুলিবিনিময়ের	গুলি
স্থিতিমাপ	স্থিতি
যাদুকর	যাদুকর
গ্রেনেডের	গ্রেনেড
অবধারিতভাবেই	অবধারিত
এলজিআরডি	এলজিআরডি
রঞ্জিত	রঞ্জিত
জিলানী	জিলানী
বাঁদিকে	দিক
বসবাসকারী	বসবাস
বাহামা	বাহামা
পারলাম	পার
মরণকারী	মরণ
সবচে	সব
নীতিবান	নীতি
হয়েছেন	হয়েছ
উর্দ্ধে	উর্দ্ধে
সমতলে	সমতল
পাঠিয়েছি	পাঠ
আইপ্যাডে	আইপ্যাড
মিষ্টি	মিষ্টি
পরিষ্কারভাবে	পরিষ্কার
সলিম	সলিম
হোটেলেই	হোটেল
অশান্তির	শান্তি
একাডেমিক	একাডেমি
ষোড়শী	ষোড়শ
সহপাঠী	পাঠ
মহাভারত	ভারত
রেঞ্জের	রেঞ্জ
প্রেরণের	প্রেরণ
ইসকান্দার	ইসকান্দা
রাশেদকে	রাশেদ
কুপি	কুপি
দুর্জয়	দুর্জয়
নথিপত্র	নথি
গল্পগুজব	গল্প
প্রফেসরের	প্রফেসর
বঙ্গভঙ্গের	বঙ্গ
আন্তবর্ণীয়	আন্তবর্ণ
প্রস্তুতিটা	প্রস্তুতি
ফেডেক্স	ফেডেক্স
হারিছ	হারিছ
মতবাদের	মতবাদ
অ্যাপ্লিকেশনটি	অ্যাপ্লিকেশন
হইহুল্লোড়	হইহুল্লোড়
নির্ধারণী	নির্ধারণ
চাচ্ছ	চাচ্ছ
আসব	আসব
জ্যাকব	জ্যাকব
ছাওয়া	ছাওয়া
উড়ানোর	উড়ানো
বুচার	বুচা
কূটনীতি	কূটনীতি
রিভারের	রিভার
ব্যাপকভিত্তিক	ব্যাপক
ছুটে	ছুট
দুনিয়াকে	দুনিয়া
অংশীদার	অংশ
জৈনধর্ম	জৈন
পরিবহনশ্রমিকদের	পরিবহন
দেইনি	দেই
শিশুশ্রমের	শিশুশ্রম
বিস্টস	বিস্ট
বৈষম্যহীন	বৈষম্য
সবচেয়ে	সব
রেডিয়েটর	রেডিয়েট
ধারণক্ষমতার	ধারণক্ষমতা
সম্ভাবনাও	সম্ভাবনা
ছওয়াব	ছওয়াব
সঞ্চয়	সঞ্চয়
সমীর	সমীর
সাহচর্য	সাহচর্য
বার্লি	বার্লি
নজিবুর	নজিবুর
ডাকটিকিটের	ডাকটিকিট
ম্যাট্রিক্সের	ম্যাট্রিক্স
মন্দের	মন্দ
দোহার	দোহা
প্রত্নসম্পদ	প্রত্ন
পতিতাবৃত্তির	পতিতা
সর্ষের	সর্ষে
জর্দার	জর্দা
সেটিংসে	সেটিংস
অসমতার	অসমতা
বাল্যকালে	বাল্য
সৃষ্টিকর্ম	সৃষ্টি
সরকারপাড়া	সরকারপাড়া
সুরেশ্বর	সুরেশ্ব
নিয়ন্ত্রণকক্ষের	নিয়ন্ত্রণ
মেধা	মেধা
উৎসবও	উৎসব
পরিবারের	পরিবার
জাবাল	জাবাল
পূর্ণসংখ্যা	পূর্ণসংখ্যা
ব্রাহ্মণবাড়ীয়া	ব্রাহ্মণবাড়ীয়া
পরিবেশবিদ্যা	পরিবেশবিদ্যা
ভিলিয়ার্স	ভিলিয়ার্স
জীবনবোধ	জীবনবোধ
টিউনিং	টিউন
ম্যাজিস্ট্রেটকে	ম্যাজিস্ট্রেট
সক্রিয়ভাবে	সক্রিয়
পাঠ্যাংশে	পাঠ্য
চলতেন	চল
ক্যানবেরায়	ক্যানবেরা
মিঠাপানির	মিঠাপানি
বিভাগগুলি	বিভাগ
কন্ট্রোলিং	কন্ট্রোল
আদমজী	আদমজী
পরিষ্কারের	পরিষ্কার
সম্প্রসারণে	সম্প্রসারণ
আউটলুক	আউটলুক
মসনদে	মসনদ
ইয়াছিনের	ইয়াছিন
ভিট	ভিট
তো	তো
উচিৎ	উচিৎ
ইন্দিরা	ইন্দিরা
শহরতলির	শহরতলি
কাগিসো	কাগিসো
ফিলিপ	ফিলিপ
বাংলা	বাংলা
শীতে	শীত
মুক্তিযোদ্ধারা	মুক্তি
সত্যায়ন	সত্য
জন্যও	জন্য
পলিটব্যুরোর	পলিটব্যুরো
পডকাস্টের	পডকাস্ট
গলানোর	গলানো
পরিচর্যাকে	পরিচর্যা
পুদিনা	পুদিনা
উপজাতীয়	জাত
কুখ্যাত	খ্যাত
ইনপুট	ইনপুট
রুগির	রুগি
সরকারপ্রধানের	সরকার
সন্ধি	সন্ধি
জনশক্তির	শক্তি
লিজা	লিজা
ডায়নামাইটস	ডায়নামাইট
খুঁজে	খুঁজ
শিলাবৃষ্টি	শিলা
দীপ	দীপ
কোমলতা	কোমল
লাজ	লাজ
মুছার	মুছা
শ্রাব্য	শ্রাব্য
প্রণয়ন	প্রণয়ন
আসামি	আস
এডিট	এডিট
যন্ত্রাদি	যন্ত্র
দেহকে	দেহ
নিশ্চয়	নিশ্চয়
খায়রুল	খায়রুল
গর্জিয়াস	গর্জিয়াস
বাড়িয়েছিলেন	বাড়ি
উপাসক	উপাসক
ভারতবর্ষে	ভারতবর্ষ
সৌম্যের	সৌম্য
কিটি	কিট
জোরেশোরে	জোরে
একান্নবর্তী	একান্ন
মাদরাসায়	মাদরাসা
নিয়েছে	নিয়ে
থামতে	থামতে
ভাওয়াইয়া	ভাওয়াইয়া
অসম্ভবের	সম্ভব
ঐতিহাসিকদের	ঐতিহাসিক
হৃদয়ের	হৃদয়
রেঙ্গুনের	রেঙ্গুন
কাঁচপুর	কাঁচপুর
আলফ্রেডো	আলফ্রেডো
ইইউয়ের	ইইউ
কনুইয়ের	কনুইয়ে
বন্দরবাজার	বন্দরবাজার
ক্রিপ্টোগ্রাফি	ক্রিপ্টোগ্রাফি
কুণাল	কুণাল
অসঙ্গত	সঙ্গত
আজিজুল	আজিজুল
হামদান	হামদান
ধূম্রজাল	ধূম্রজাল
মুহসিন	মুহসিন
ভাতিজি	ভাতিজি
মাইকা	মাইক
নারীসুলভ	নারী
আসনও	আসন
খাওয়াতেন	খাও
জাপানীজ	জাপান
অসুবিধাগুলো	অসুবিধা
এনজাইম	এনজাইম
নিজেদেরও	নিজেদের
বাসিন্দাদের	বাসিন্দা
পণ্যসম্ভার	পণ্য
উইকলি	উইক
কর্কট	কর্কট
পলিটিক্যাল	পলিটিক্যাল
ডেনিসের	ডেনিস
বেড়িবাঁধ	বেড়িবাঁধ
লোকজন	লোক
অভিজ্ঞতাটি	অভিজ্ঞতা
পঠিত	পঠিত
ধারণক্ষমতা	ধারণ
ধর্ষকদের	ধর্ষক
পর্যটকের	পর্যটক
কাপুরুষের	পুরুষ
মার্কেটের	মার্কেট
খোদাইকৃত	খোদাই
শুনব	শুন
শিল্প	শিল্প
ঝুম	ঝুম
অভিভাবকহীন	অভিভাবক
মিয়ামি	মিয়ামি
সম্পত্তির	সম্পত্তি
সাক্ষি	সাক্ষি
মুছতে	মুছ
চাকরিবাকরি	চাকর
মিলিশিয়াদের	মিলিশিয়াদ
মার্ফি	মার্ফি
সুখ্যাতি	খ্যাতি
কলোনি	কলোনি
প্রবাস	প্রবাস
নিবি	নিবি
এনএফ	এনএফ
শান্তিনিকেতন	শান্তিনিকেতন
ছিনতাইকারী	ছিনতাই
লোকচক্ষুর	চক্ষু
অংশবিশেষের	অংশবিশেষ
ভ্রমন	ভ্রমন
ডাচরা	ডাচ
নেতৃত্বদানকারী	নেতৃত্বদান
বেকন	বেক
এতীমকে	এতীম
টয়লেটে	টয়লেট
রকমটা	রকম
যাইতে	যাই
কানাডাতে	কানাডা
দণ্ড	দণ্ড
ভেহিকল	ভেহিকল
রক্তচোষা	রক্ত
ওয়েলিংটনের	ওয়েলিংটন
মিলনস্থল	মিলন
ব্যাকলাইট	ব্যাকলাইট
ডুলাহাজারা	ডুলাহাজারা
রোম	রোম
বানাত	বানাত
নিয়েছিলেন	নিয়েছিল
দিও	দিও
এতদ	এতদ
দীর্ঘসহিষ্ণু	দীর্ঘ
মাতোয়ারা	মাতোয়ারা
পরিবেশসম্মত	পরিবেশ
যুক্তিই	যুক্তি
পূজামণ্ডপে	পূজা
ক্যামেরন	ক্যামেরন
প্রকৃতপক্ষেই	প্রকৃত
কানাচে	কানাচ
অপারেশনটি	অপারেশন
লখনৌ	লখনৌ
সমর্থনের	সমর্থন
ধর্মতত্ত্বের	ধর্ম
কাগজপত্রের	কাগজপত্র
সিটিএন	সিটিএন
সিদ্ধ	সিদ্ধ
যাচ্ছেন	যাচ্ছ
পরাশক্তি	পরাশক্তি
ইমি	ইমি
আপনারে	আপনার
প্রযুক্তিবিষয়ক	প্রযুক্তিবিষয়ক
সুপারফরেক্স	ফরেক্স
বিন্যাসের	বিন্যাস
ব্রুকলিনে	ব্রুকলিন
ক্লান্তিতে	ক্লান্ত
ইন্সপেকশন	ইন্সপেকশন
জিলিয়ান	জিলিয়ান
পাকুড়িয়া	পাকুড়িয়া
সিলেবাসে	সিলেবাস
নগরের	নগর
জ্বালো	জ্বাল
পতিতা	পতিতা
কৃতিপরায়ণ	কৃতি
ন্যুড	ন্যুড
জিটিএ	জিটিএ
প্রত্যয়	প্রত্যয়
পঁয়তাল্লিশ	পঁয়তাল্লিশ
কাস	কাস
শর্তাবলীর	শর্তাবলী
মানসিকতা	মানসিক
উপক	উপক
সালামি	সালামি
রান্নাবান্না	রান্নাবান্না
সপ্রতিভ	প্রতিভ
জয়েন্টগুলোতে	জয়েন্ট
আপত	আপত
কইরেন	কইরেন
হার্দিক	হার্দিক
ব্যাপারটিতে	ব্যাপার
হায়রে	হায়
থালাবাসন	থালাবাসন
মেরামতকাজ	কাজ
নগরবাড়ী	নগর
নীলক্ষেত	নীলক্ষেত
প্রত্যয়িত	প্রত্যয়
মারামারি	মারামারি
অসামাজিক	সামাজিক
উদ্দেশ্যমূলক	উদ্দেশ্য
সম্পদের	সম্পদ
অভ্যাসকে	অভ্যাস
মহেশখালী	মহেশখালী
পেশাজীবীরা	পেশা
ফাঁসের	ফাঁস
মেনে	মেনে
ম্যাক্সসকাল	সকাল
ওয়াকিবহাল	ওয়াকিবহাল
অভিঘাত	ঘাত
লালমনিরহাটে	লালমনিরহাট
খণ্ডকালীন	খণ্ড
মেলবোর্ন	মেলবোর্ন
প্রসেস	প্রসেস
আমাদেরও	আমাদের
কাউন্সিল	কাউন্সিল
আড্ডায়	আড্ডা
বিরুদ্ধাচরণ	বিরুদ্ধ
শিফন	শিফন
থোড়াই	থোড়া
পেজে	পেজ
সারাকে	সারা
মহিপাল	মহিপাল
আসক্তি	আসক্তি
দারুল	দারুল
টানা	টান
ঘটনাগুলো	ঘটনা
জঙ্গিবাদী	জঙ্গি
নিয়মিতভাবে	নিয়মিত
বাস্তবিক	বাস্তব
ডেটাবেজ	ডেটাবেজ
আইএইএ	আইএইএ
রোমানিয়ান	রোমানিয়া
নিমিত্তে	নিমিত্তে
দৈনিকে	দৈনিক
লরেন্ট	লরেন্ট
ডাইরেক্টরি	ডাইরেক্টর
শিয়াল	শিয়াল
কসাই	কসাই
পার্বতীপুরের	পার্বতী
বিরোধীতার	বিরোধী
ট্যান্ডন	ট্যান্ডন
ঘটনাক্রমে	ঘটনাক্রম
রেমাক্রি	রেমাক্রি
প্লেলিস্ট	প্লেলিস্ট
রেডহ্যাট	রেড
গুলোও	গুলো
এগোচ্ছে	এগোচ্ছ
মুসাফিরদের	মুসাফির
ফলেন	ফলে
করানোর	কর
রোডের	রোড
জংশনে	জংশন
প্রার্থনাও	প্রার্থনা
মিনকালেও	মিনকাল
ফার্সী	ফার্সী
লাগবেই	লাগবে
পৃষ্ঠপোষকতা	পৃষ্ঠপোষক
মিচেলের	মিচেল
নীতিহীন	নীতি
আগামীকাল	কাল
কালিয়াকৈরের	কালিয়াকৈর
জামাকাপড়	জামা
ক্রোধ	ক্রোধ
জোড়াতালি	জোড়া
সুলাইমান	সুলাইমান
জ্যাম	জ্যাম
স্টেশনমাস্টার	স্টেশন
ডেকেছিলাম	ডেকেছিলাম
ভেন্ডিং	ভেন্ড
সম্মানার্থে	সম্মান
শাহাদাৎ	শাহাদাৎ
কাউন্সিলকে	কাউন্সিল
ডাকো	ডাকো
তালিকাভুক্তি	তালিকা
পুরের	পুর
সরকারেরই	সরকার
বাগবাড়ি	বাগবাড়ি
প্যানেলের	প্যানেল
আলিশা	আলিশা
বসল	বস
কাপুরুষতা	পুরুষ
পশুকে	পশু
হয়রানি	হয়রানি
তৈয়বুর	তৈয়বুর
চ্যাম্পিয়নশীপের	চ্যাম্পিয়ন
আনন্দময়	আনন্দ
পরিবাহকের	পরিবাহক
পরিবেশ	পরিবেশ
লতা	লতা
ছোড়েন	ছোড়ে
উপমহাব্যবস্থাপক	ব্যবস্থাপক
তুলকালাম	তুলকালাম
বরাবরের	বরাবর
রুবেলের	রুবেল
বিচারহীনতা	বিচার
বিটা	বিটা
পররাষ্ট্রবিষয়ক	পররাষ্ট্র
ডুবেছে	ডুব
শ্রমিকেরাও	শ্রমিক
মেষপালকের	মেষ
মেডুসা	মেডুসা
জোস্	জোস্
বিড়ি	বিড়ি
একডালা	এক
ডিএমডি	ডিএমডি
আইপিইউ	আইপিইউ
হুডের	হুড
ব্রেইল	ব্রেইল
দ্রুতগতির	দ্রুতগতি
ভক্ষণ	ভক্ষণ
শিক্ষাব্যবস্থায়	শিক্ষাব্যবস্থা
ডলস	ডল
ওয়েলথ	ওয়েলথ
অবিশ্বাস্য	শ্বাস
ভাইদের	ভাই
বার্নাড	বার
নগরী	নগর
কারবি	কারবি
ন্যায়সঙ্গত	ন্যায়
ইউএইচএফ	ইউএইচএফ
বিনিয়োগকারীরা	বিনিয়োগকারী
শওকত	শওকত
বিবরণ	বরণ
কেনাকাটায়	কেনাকাটা
গ্যাসকে	গ্যাস
ক্যাবিনেটের	ক্যাবিনেট
গাইবান্ধার	গাইবান্ধা
ওবি	ওবি
বালিয়াডাঙ্গী	বালিয়াডাঙ্গী
প্রমাণিত	প্রমাণ
মাজিদ	মাজিদ
ম্যানিলা	ম্যানিলা
গঠিত	গঠিত
সন্তুষ্টি	সন্তুষ্টি
সেন্সর	সেন্সর
একাধারে	একাধার
মোরেলগঞ্জ	মোরেলগঞ্জ
উড়ালপুল	উড়ালপুল
অন্যথা	অন্য
লায়লা	লায়লা
লক্ষ্মীছড়ি	লক্ষ্ম
ঝুলছে	ঝুল
মাসের	মাস
শিক্ষার্থীও	শিক্ষার্থী
ঝক্কি	ঝক্কি
রাতারাতি	রাত
ছেড়ে	ছেড়ে
রাখালী	রাখাল
হসপিটালের	হসপিটাল
কোপল্যান্ড	কোপল্যান্ড
কারাপরিদর্শক	কারাপরিদর্শক
সুইডীয়	সুইড
সদ্যজাত	সদ্য
অবরোধ	রোধ
চোট	চোট
ম্যাগাজিনকে	ম্যাগাজিন
দুরত্বে	দুরত্ব
যেক্ষেত্রে	যেক্ষেত্র
চিনিয়েছেন	চিনি
মীমাংসা	মীমাংসা
কাটারের	কাটার
হচেছ	হচেছ
প্রহার	প্রহার
হলটি	হল
ব্রিন	ব্রিন
সহি	সহি
উক্তির	উক্তি
অধিবর্ষে	অধিবর্ষ
জোটে	জোট
বর্গমাইল	বর্গমাইল
টসের	টস
বাদে	বাদ
ভাস্বর	ভাস্বর
ফ্রাণ্সের	ফ্রাণ্স
সমাবেশে	সমাবেশ
সঙগে	সঙগ
সাংবাদিককে	সাংবাদিক
পশ্চিমে	পশ্চিম
ক্রিকেটারদের	ক্রিকেট
জোসে	জোস
শান্তিরক্ষীদের	শান্তি
ফুটবলাররা	ফুটবলার
সুপারনোভা	সুপারনোভা
ওয়াস্তে	ওয়া
যানে	যান
নেতাজী	নেতা
ছাঁচের	ছাঁচ
পবিত্রদের	পবিত্র
ফার্মাসিস্টের	ফার্মাসিস্ট
ভূমিকাও	ভূমিকা
দাশগুপ্তের	দাশগুপ্ত
স্কোরলাইন	স্কোরলাইন
পারফরম্যান্সের	পারফরম্যান্স
তথ্যচিত্রে	তথ্য
ফাইন্যান্সিয়াল	ফাইন্যান্স
প্রসারণ	সারণ
মেসে	মেস
এখানেই	এখান
লোক	লোক
সখা	সখা
জেনির	জেনি
অন্তর্বর্তীকালীন	অন্তর্বর্তী
বাড়বেই	বাড়বে
বেলুচিস্তানে	বেলুচিস্তান
কাড়ি	কাড়ি
বঙ্গমাতা	বঙ্গমাতা
আনন্দদায়ক	আনন্দ
সাউদাম্পটনে	সাউদাম্পটন
সংক্রমণ	সংক্রমণ
জিতলেও	জিত
গেমসের	গেমস
প্রোফাইলের	প্রোফাইল
যাত্রীরাও	যাত্রী
ড্রাইভে	ড্রাইভ
কোয়াসারসমূহের	কোয়াসার
সাতমাথা	মাথা
ইউপি	ইউপি
স্নায়ু	স্নায়ু
লঙ্কান	লঙ্কা
আশ্রয়ের	আশ্রয়
জিনোম	জিনোম
রাফিদা	রাফি
শাইখুল	শাইখ
যুগলবন্দী	যুগল
কলম্বিয়া	কলম
সুনজর	সুনজর
সমতাসূচক	সমতা
রায়	রায়
মারটি	মার
ক্যালেন্ডারটি	ক্যালেন্ডার
অজুহাত	অজুহাত
তথ্যাবলী	তথ্য
ট্রেডার্সের	ট্রেডার্স
স্থলবন্দর	স্থলবন্দর
কভারে	কভার
স্ট্রাকচারের	স্ট্রাকচার
লিলির	লিলি
মেয়েটাকে	মেয়ে
রক্তচাপের	রক্তচাপ
রয়্যাল	রয়্যাল
বিশ্বশক্তির	বিশ্ব
টেন্সর	টেন্সর
ছাড়াই	ছাড়
এএআই	এএআই
মীজানুর	মীজানুর
সন্ত্রাসবিরোধী	সন্ত্রাস
প্রত্যাবর্তিত	প্রত্যাবর্তি
জ্যোতির্বিদ্যার	জ্যোতি
ক্যাম্পেইনের	ক্যাম্পেইন
সরি	সরি
তাতা	তাতা
ঢাকাস্থ	ঢাকা
হাম্পটি	হাম্পটি
পাম্প	পাম্প
অকল্যান্ড	অকল্যান্ড
ঘোনা	ঘোনা
ইন্ডোর	ইন্ডোর
ইলেকট্রিক	ইলেকট্রিক
প্যাকগুলি	প্যাক
লাইসেন্সের	লাইসেন্স
চেরাই	চেরা
বৈঠকে	বৈঠক
দেড়টা	দেড়
শতাব্দি	শতাব্দ
দায়িত্বহীন	দায়িত্ব
প্রত্যেককে	প্রত্যেক
পুলিশসহ	পুলিশ
তফসিল	তফসিল
ডিএফও	ডিএফও
ট্রাকটি	ট্রাক
অ্যান্টার্কটিকার	অ্যান্টার্কটিকা
পিডিএফে	পিডিএফ
পেগাসাস	পেগাসাস
রাজীব	রাজীব
ক্লাবগুলোকে	ক্লাব
রিভিউয়ের	রিভিউ
পেয়েছে	পেয়েছ
দশায়	দশা
ইনফ্রা	ইনফ্রা
ওয়েলস	ওয়েলস
বিরোধ	বিরোধ
প্রাঙ্গন	প্রাঙ্গন
ক্ষেত্রমত	ক্ষেত্র
অধিভুক্তি	অধিভুক্ত
সন্ন্যাসিনী	সন্ন্যাসি
মহাকালের	কাল
সাহেবগঞ্জ	সাহেবগঞ্জ
মনোহরদী	মনোহরদী
প্রকল্পগুলিতে	প্রকল্প
দেখিয়েছে	দেখিয়েছ
ইসলামের	ইসলাম
অস্ত্রমুক্ত	অস্ত্র
এমটিভি	এমটিভি
আবলুস	আবলুস
কাভার	কাভার
পৌঁছানোর	পৌঁছান
হিমু	হিমু
দিবসের	দিবস
ফাইটার	ফাইটার
বাঁশঝাড়ে	বাঁশঝাড়
কার্যের	কার্য
বাঙ্গালা	বাঙ্গাল
প্রাইভেট	প্রাইভেট
বিপর্যয়ের	বিপর্যয়
যাতায়াতকারী	যাতায়াত
রিলিজিয়ন	রিলিজিয়ন
খারাপের	খারাপ
অঞ্চলজুড়ে	অঞ্চল
চন্দরপল	চন্দরপল
লোম	লোম
কলাপসিবল	কলাপসিবল
বশবর্তী	বশবর্তী
সারোগেসির	সারোগেসি
লংঘন	লংঘন
মাওয়ায়	মাওয়া
বোলিংটা	বোলিং
চাইল্ড	চাইল্ড
পরিক্রমা	পরিক্রম
প্রণয়নের	প্রণয়ন
পরিচয়কে	পরিচয়
সন্ত্রাসের	সন্ত্রাস
যুক্তফ্রন্টের	ফ্রন্ট
মোশাররফকে	মোশাররফ
কক্সবাজার	কক্সবাজার
সহোদরের	সহোদর
নিয়মাবলি	নিয়ম
দাদুকে	দাদু
সীমান্তে	সীমান্ত
বন্য	বন্য
রুমাল	রুমাল
মার্টিনে	মার্টিন
শহরও	শহর
লুকানোর	লুকানো
কোরিয়াকে	কোরিয়া
ভ্যানচালক	ভ্যান
জানালাগুলো	জানালা
কর্নারে	কর্নার
থায়ীভাবে	থায়ী
কামুক	কাম
সিংহভাগই	সিংহভাগ
হূদয়ে	হূদয়
জন্মঃ	জন্ম
পাস্ট	পাস্ট
দ্বিতীয়ত	দ্বিতীয়
একটিমাত	এক
প্রিন্টারের	প্রিন্টার
সাথিরা	সাথি
ফয়সাল	ফয়সাল
নিদাহাস	নিদাহাস
ক্ষয়কারক	ক্ষয়
স্লিভার	স্লিভ
ডিনারের	ডিনার
সিরিজই	সিরিজ
কার্যাবলির	কার্য
এক্সের	এক্স
প্রজেকশন	প্রজেকশন
সিউলের	সিউল
প্রশাসকের	শাসক
অর্থ	অর্থ
মালিকপক্ষের	মালিক
ধরমপাশা	ধরমপাশা
ঐতিহ্যের	ঐতিহ্য
কালীমন্দির	কালীমন্দির
অনুসরন	সরন
সেনাবাহিনীকে	বাহিনী
জ্যাককে	জ্যাক
ট্যুর	ট্যুর
উসামা	উসামা
গোল্ডের	গোল্ড
রাজনীতিবিদ	রাজ
বার্তাই	বার্তা
জুরিখে	জুরিখ
আড়াইটায়	আড়াই
সিআইএর	সিআইএ
সেটআপ	সেটআপ
সেন্টের	সেন্ট
পুজা	পুজা
কয়ে	কয়
সোনিয়ার	সোনিয়া
রেগুলেটরি	রেগুলেটর
পুনর্নিরীক্ষণের	র্নিরীক্ষণ
তালগাছ	তাল
ফেডের	ফেড
মন্ত্রিত্ব	মন্ত্রি
কাহিনিচিত্র	কাহিনি
রূপরেখা	রূপ
ডিবির	ডিবি
জলাতঙ্ক	জলাতঙ্ক
উন্নয়নশীল	উন্নয়ন
কোরিয়া	কোরিয়া
শিক্ষানবিশ	শিক্ষা
ব্যাবহারের	ব্যাবহার
কারণবশত	কারণ
গ্রামগুলো	গ্রাম
কাণ্ড	কাণ্ড
বৃদ্ধা	বৃদ্ধ
সাদাপোশাকের	পোশাক
আশরাফুজ্জামান	আশরাফুজ্জামান
সিভিক	সিভি
মনরোর	মনরো
থাপনের	থাপন
ডিসান	ডিসান
বিভূষিত	বিভূষিত
শ্রীপুরের	শ্রীপুর
শোভা	শোভা
মুসলিমপ্রধান	মুসলিম
ইউএসটিসির	ইউএসটিসি
জনমুক্তি	জন
ইচ্ছাশক্তির	ইচ্ছা
নেছারাবাদ	নেছারাবাদ
মরিয়মের	মরিয়ম
সংখ্যাই	সংখ্যা
উপভাষা	ভাষা
লতিকা	লতিকা
রেস্টুরেন্টে	রেস্টুরেন্ট
টিনএজ	টিনএজ
উত্পাটন	উত্পাটন
বৈঠকের	বৈঠকের
প্রজাতন্ত্রের	জাত
আতহার	আতহার
সমাকামীর	সমাকামী
ফরমালিনের	ফরমালিন
মার্লিন	মার্লিন
এলোপাতাড়ি	এলোপাতাড়
সেন	সেন
রকিবের	রকিব
তাৎপর্য	তাৎপর্য
কিশোরগঞ্জের	কিশোরগঞ্জ
ডিইউজে	ডিইউজ
সিকদারকে	সিকদার
সত্যব্রত	সত্য
ম্যালেরিয়ার	ম্যালেরিয়া
কিছুতে	কিছু
চেহারাটা	চেহারা
রণবীরকে	রণবীর
দলগত	দল
পদচ্যুত	পদ
দস্তুর	দস্তু
মনোনিবেশ	মন
পাইপ	পাইপ
তাজা	তাজ
প্ররোচক	প্ররোচক
শিল্পকর্মটি	শিল্প
জমকালো	কালো
কমন্সে	কমন্স
সম্পর্কীয়	সম্পর্ক
ঠাগত	ঠাগত
মফিদুল	মফিদুল
জানালায়	জানালা
ঝাঁকানো	ঝাঁকা
জন্মদিনে	জন্মদিন
সৌম্য	সৌম্য
বিমানসংস্থা	মান
ওপার	ওপার
ল্যাবরেটরিজ	ল্যাবরেটরি
জাতিগত	জাত
বাকশাল	বাকশাল
ভাইঝি	ভাই
সাফ	সাফ
স্ট্রিপের	স্ট্রিপ
বাণীতে	বাণী
সূর্যমুখীর	সূর্যমুখী
শব্দগুচ্ছ	শব্দ
নওজোয়ান	নওজোয়ান
যথাস্থানে	যথাস্থান
বলিষ	বল
থাই	থাই
হুমায়ূনের	হুমায়ূন
সিভি	সিভি
এইরূপ	এইরূপ
উপহারগুলো	উপহার
লিখছে	লিখছ
শীতলকারী	শীত
কেন্দ্রের	কেন্দ্র
লোকটার	লোকটা
জীবনবিমা	জীবন
নেতৃবৃন্দ	নেতৃবৃন্দ
নিউরোসায়েন্স	সায়েন্স
অল্পবয়স্ক	অল্প
দাবিই	দাবি
তেলেগু	তেলেগু
ভৌগোলিকভাবে	ভৌগোলিক
নাইটদের	নাইট
শ্রমে	শ্রম
থাকা	থাক
ডাকসু	ডাকসু
হুয়াওয়ের	হুয়াওয়ের
নয়ন	নয়ন
লিসবনের	লিসবন
বাসিন্দার	বাসিন্দা
উঠবেই	উঠবে
আবর্তনশীল	আবর্তন
পীড়াদায়ক	পীড়া
খাটো	খাটো
রকওয়েল	রকওয়েল
অটোমেশন	অটোমেশন
উপল	উপল
মুর্শেদ	মুর্শেদ
ফার্নান্দেজ	ফার্নান্দেজ
কুফল	ফল
ভরাট	ভর
কপিরাইটযুক্ত	কপিরাইট
শিল্পায়নের	শিল্প
ডেনিশ	ডেনিশ
শ্যাফ্ট	শ্যাফ্ট
নোবিতা	নোবিতা
পাদ্রী	পাদ্রী
চলচ্চিত্রসহ	চলচ্চিত্র
রিসার্চের	রিসার্চ
ক্লিনিকে	ক্লিনিক
সাইটগুলিতে	সাইট
পর্যটককে	পর্যটক
সমাধানের	সমাধান
কাসিম	কাসিম
পাটিগণিত	গণিত
মার্ভেলের	মার্ভেল
যুবসমাজকে	যুবসমাজ
বোট	বোট
ভোজ্যতেল	তেল
লুনার	লুনা
মনিহারি	মনিহার
অধ্যাপককে	অধ্যাপক
ফরওয়ার্ডার	ফরওয়ার্ড
ক্রিয়াপদের	ক্রিয়া
হয়েছিলাম	হয়
বদরে	বদর
ফ্রেডেরিক	ফ্রেডেরিক
অধিনায়কই	অধিনায়ক
সামাজিকীকরণ	সামাজিক
আঁকছেন	আঁক
বিএসপি	বিএসপি
পড়ছিলাম	পড়ছিলাম
সর্বসম্মতিক্রমে	সর্বসম্মতি
রবার্টসন	রবার্টসন
পদধ্বনি	পদধ্বনি
রাষ্ট্রযন্ত্র	রাষ্ট্র
পাচ্ছিলাম	পাচ্ছিলাম
ধারাভাষ্যকারের	ধারাভাষ্যকার
বৈঠকখানায়	বৈঠক
পাইনের	পাইন
বুননের	বুনন
কিত	কি
ধীরাজ	ধীরাজ
অপসারণকে	অপসারণ
হজ্জ	হজ্জ
সংগঠনগুলোর	সংগঠন
উপসাগরের	উপসাগর
মনুষ্যপুত্ত্র	মনুষ্য
রুবাইয়াত	রুবাইয়াত
শীর্ষস্থানে	শীর্ষ
গোলমাল	গোলমাল
গালিচা	গালিচা
জবানবন্দিতে	জবান
ফ্যাক্টর	ফ্যাক্টর
বরদাশত	বরদাশত
ডুয়েট	ডুয়েট
কেচাপ	কেচাপ
মিলনমেলা	মিলনমেলা
ভোলা	ভোল
আকাশমণ্ডল	আকাশ
ভিনসেন্ট	ভিনসেন্ট
ধুনটে	ধুনট
টিআইএন	টিআইএন
আলজেরিয়া	আলজেরিয়া
রাসায়নিকের	রাসায়নিক
অংশীদারিত্বে	অংশীদার
অসাম্প্রদায়িকতা	সাম্প্রদায়
দাবায়	দাবা
আদিবাসীর	আদিবাসী
বক্ষদেশ	বক্ষ
হর্নবি	হর্ন
অমান্য	মান্য
ক্র্যাকিং	ক্র্যাক
নিদ্রাহীন	নিদ্রা
জহুরুল	জহুরুল
জাতীয়তাবাদীদের	জাতীয়তাবাদী
ব্ল্যাকবেরির	ব্ল্যাকবেরি
কেয়ারে	কেয়ার
গাজীকে	গাজী
হাজীপাড়া	হাজীপাড়া
টার্ম	টার্ম
হেলা	হেলা
হেফাজতের	হেফাজত
অগমেন্টেড	অগমেন্টেড
যাইহোক	যা
নেপথ্যের	পথ
হ্রাসপ্রাপ্ত	হ্রাস
পাঁচ	পাঁচ
অর্থায়নের	অর্থায়ন
অনুর	অনু
ডিউক	ডিউক
চিপের	চিপ
ঘেমে	ঘেমে
গর্বিত	গর্ব
মহাশক্তিশালী	শক্তি
ফিলিস্তিন	ফিলিস্তিন
বাতায়ন	বাতায়ন
নিশ্চিন্তে	নিশ্চিন্ত
চেয়ারে	চেয়ার
ওঠেছিল	ওঠেছিল
সহকর্মী	কর্ম
আশ্বস্ত	আশ্বস্ত
দয়াগঞ্জ	দয়াগঞ্জ
প্রয়োজনের	প্রয়োজন
নলকূপে	নল
নেহেরু	নেহেরু
স্যাক্সন	স্যাক্সন
আর্জেন্টিনীয়	আর্জেন্টিন
সাংগ্রাই	সাংগ্রাই
সহযোগিতাকে	সহযোগিতা
তল্লাশিচৌকিতে	তল্লাশি
উচ্চমাধ্যমিক	মাধ্যমিক
পাটোয়ারি	পাটোয়ারি
বিশিষ্ট	বিশিষ্ট
সাঙ	সাঙ
ক্ষমতাপ্রাপ্ত	ক্ষমতা
আকারেই	আকার
সংবাদকর্মী	সংবাদ
এতিমের	এতিম
তিরস	তিরস
ওয়াল্ড	ওয়াল্ড
গ্রেনেড	গ্রেনেড
কন্নড়	কন্নড়
কমপ্লেক্সে	কমপ্লেক্স
গ্রাজুয়েট	গ্রাজুয়েট
ইকরা	ইকরা
প্রচারাভিযানে	প্রচারাভিযান
হারিয়েছি	হারিয়ে
প্লানেট	প্লানেট
দেখাবে	দেখা
পল্টন	পল্টন
জিডিপি	জিডিপি
শান্তিতে	শান্তি
বিদ্যালয়কে	বিদ্যালয়
দাঁড়িয়েছে	দাঁড়িয়
মোকাবিলায়	মোকাবিলা
বর্ণিল	বর্ণ
কুয়ার	কুয়ার
ভিসুয়াল	ভিসুয়াল
ধর্মগুলোর	ধর্ম
নাটকটি	নাটক
বেলতলা	বেলতলা
স্বামীই	স্বামী
চড়েন	চড়
ভালোমতোই	ভালো
দ্বীপগুলিতে	দ্বীপ
সঙ্গম	সঙ্গম
বলতেও	বল
সমাজেও	সমাজ
চীফ	চীফ
নাগরিকদেরকে	নাগরিক
সাবসিডিয়ারি	সাবসিডিয়ারি
আযাবে	আযাব
কাঁদেন	কাঁদে
মনোরঞ্জন	মনোরঞ্জন
গ্লোরি	গ্লোরি
অতৃপ্তি	তৃপ্তি
এক্সট্রুড	এক্সট্রুড
চিত্রশিল্পীর	শিল্প
তাজ্জব	তাজ্জব
ইন্ডাস্ট্রির	ইন্ডাস্ট্রি
অধঃপতিত	অধঃপতিত
হৃদপিণ্ড	হৃদপিণ্ড
করিতেন	কর
ল্যাঙ্গার	ল্যাঙ্গার
কুয়াশাচ্ছন্ন	কুয়া
ভাটায়	ভাটা
ঝাপসা	ঝাপসা
অনেক	অনেক
বিস্তারিত	বিস্তার
ইসলামও	ইসলাম
ম্যাসেডোনিয়া	ম্যাসেডোনিয়া
সক্রেটিস	সক্রেটিস
স্পর্শকাতর	স্পর্শ
আড়াআড়ি	আড়াআড়ি
আহতদের	আহত
শতবর্ষপূর্তি	শতবর্ষ
শ্রীকৃষ্ণকীর্তন	শ্রীকৃষ্ণ
চালানোর	চালানো
শবর	বর
নিষ্কলঙ্ক	নিষ্কলঙ্ক
ওয়ালের	ওয়াল
একাডেমীর	একাডেমী
বিদায়	বিদায়
তফসিলী	তফসিল
যুক্তরাষ্ট্রের	যুক্তরাষ্ট্র
কারাভোগ	কারা
ফ্লাইটটি	ফ্লাইট
তৃতীয়াংশই	তৃতীয়
মাথাই	মাথা
বাচানোর	বাচা
মানহীন	মান
বোঝাই	বোঝা
লীগেরই	লীগ
এন্ডারসনের	এন্ডারসন
আর্মেনিয়ান	আর্মেনিয়া
ময়নামতী	ময়নামতী
বেদুঈন	বেদুঈন
বসছে	বসছে
দেওয়ানি	দেওয়ান
ঠেকাতে	ঠেকা
পর্যাপ্ত	পর্যাপ্ত
যেভাবেই	যেভাব
ধমক	ধমক
সুরঞ্জিত	সুরঞ্জিত
লাবু	লাবু
কিশোরবয়সি	বয়স
প্রকৌশলীর	প্রকৌশলী
এইচএসবিসির	এইচএসবিসি
সিংহাসনের	সিংহাসন
টলারেন্স	টলারেন্স
শতাংশও	শতাংশ
পেল	পেল
ইলেকট্রনিকস	ইলেকট্রনিকস
রঙ্গনা	রঙ্গন
পিঁপড়ের	পিঁপড়ের
ব্যাংকগুলির	ব্যাংকগুলি
পড়িয়ে	পড়
প্রবনতা	প্রবন
সহিংসতাকে	সহিংস
ডিটেকশন	ডিটেকশন
দরজার	দরজা
পুংলিঙ্গ	পুংলিঙ্গ
টহল	টহল
বিভীষিকার	বিভীষিকা
মেশিনারি	মেশিনারি
বানেশ্বর	বানেশ্বর
যূথিকা	যূথিকা
দীক্ষা	দীক্ষা
ভাস্কর	ভাস্কর
বচ্চনের	বচ্চন
ঘুমাও	ঘুমা
ছাপা	ছাপ
ডকিন্স	ডকিন্স
আবেগীয়	আবেগ
শূরার	শূরা
উসাইন	উসাইন
খুঁড়ে	খুঁড়ে
আয়তনের	আয়তন
ইউনিলিভারের	ইউনিলিভার
উচ্চকণ্ঠে	উচ্চকণ্ঠ
রটি	রটি
সটকে	সটক
হাসার	হাসা
ভরণ	ভরণ
আড়চোখে	চোখ
কালির	কালি
একাংশের	একাংশ
প্রতিস্থাপনযোগ্য	প্রতিস্থাপন
মৌলের	মৌল
পরিক্ষা	পরিক্ষা
সুদানে	সুদান
পিস্তল	পিস্তল
টেকনিক	টেকনিক
মভীরুতা	ভীরুতা
পাইপগান	পাইপ
ব্রিটানিকা	ব্রিটানিকা
শুনতেন	শুনতে
রূপেই	রূপ
বোঝ	বোঝ
ফলদ	ফল
গহন	গহন
জোরেশোরেই	জোরে
প্রকৃতির	প্রকৃতি
রিপোর্ট	রিপোর্ট
গবেষণাগ্রন্থ	গবেষণা
প্রস্তুতকারকদের	প্রস্তুত
বেচারা	বেচারা
ট্রান্সভালের	ট্রান্সভাল
শলোমনকে	শলোমন
পথের	পথ
সীনয়	সীনয়
পুণরায়	পুণরায়
নখর	নখ
শর্করার	শর্করা
সিগাল	সিগাল
আবদুল্লাহর	আবদুল্লাহ
উভয়ের	ভয়
কোরিয়ায়	কোরিয়া
ইউনিফর্মের	ইউনিফর্ম
ঘুরছি	ঘুর
রমনার	রমনা
জেভিয়ার্স	জেভিয়ার্স
দর্শনবিদ্যা	দর্শন
অ্যাজটেক	অ্যাজটেক
সরকারকেও	সরকার
যুগপৎ	যুগ
দুর্নীতিমুক্ত	দুর্নীতি
আনসারী	আনসার
কটা	কটা
লক্ষিত	লক্ষি
লাহোরের	লাহোর
কাওকে	কাওকে
কম্পাঙ্কের	কম্পাঙ্ক
শরীরকে	শরীর
চাচ্ছিলেন	চাচ্ছি
স্থানকালের	স্থানকাল
খাওয়ালেন	খাওয়া
প্রাথমিকে	প্রাথমিক
কফিনে	কফিন
গতিতে	গতি
হিনো	হিনো
মিশিগানে	মিশি
বয়সে	বয়স
তাড়াতে	তাড়া
ব্যবসায়	ব্যবসা
সুপারকে	সুপার
সীমাবদ্ধতার	সীমাবদ্ধতা
গাব্রিয়েল	গাব্রিয়েল
শিখি	শিখি
রমেশ	রমেশ
চীনেও	চীন
রোজাদার	রোজাদার
ফুটবলে	ফুটবল
সাফিয়া	সাফিয়া
চলেছিলে	চল
পুষ্টি	পুষ্ট
সুগন্ধা	সুগন্ধ
আঞ্চলিক	আঞ্চল
দেখলেও	দেখ
মেলাও	মেলা
ফ্লিট	ফ্লিট
তাহারা	তাহারা
হিরু	হিরু
খাঁচায়	খাঁচা
বিশ্বাসঘাতকদের	বিশ্বাসঘাতক
মাধ্যমের	মাধ্যম
গিভিং	গিভ
গ্লাসে	গ্লাস
বুসান	বুসান
ফার্মে	ফার্ম
দর্শকের	দর্শক
কিউইদের	কিউই
ধারণে	ধারণ
বুদ	বুদ
নাগেশ্বরী	নাগেশ্বর
আরেকটা	আরেক
গিয়াস	গিয়াস
হাতের	হাত
বেধড়ক	বেধড়ক
দাবদাহ	দাবদাহ
প্লেসিস	প্লেসিস
লোভের	লোভ
সুশুভ	শুভ
জিওফ	জিওফ
চিকিৎসাব্যবস্থা	চিকিৎসা
দামেস্ক	দামেস্ক
তরুণীরা	তরুণ
সুখের	সুখ
ঘাসে	ঘাস
লির	লির
জিমার	জিম
আলবদররা	আলবদর
অমৃতসর	অমৃতসর
চালিকা	চালিক
যিহিষ্কেল	যিহিষ্কেল
ডিএপি	ডিএপ
কাঁচাবাজারে	বাজার
সিরীয়	সিরীয়
জন্মবার্ষিকী	জন্মবার্ষিকী
ওঝার	ওঝা
প্রাণীগুলোর	প্রাণী
সাংবাদিকতা	সাংবাদিক
ইউক্রেইন	ইউক্রেইন
দখলে	দখল
নামটা	নাম
স্লিপের	স্লিপ
আইসিডিডিআরবি	আইসিডিডিআরবি
শৌখিন	শৌখিন
ইনফ্লুয়েঞ্জা	ইনফ্লুয়েঞ্জা
ঐতিহাসিকের	ঐতিহাসিক
পায়ু	পায়ু
ইনস্যুরেন্স	ইনস্যুরেন্স
মহিম	মহিম
থলি	থলি
পায়ের	পা
ডিএসএম	ডিএসএম
লুক	লুক
ছাতক	ছাতক
ঘূর	ঘূর
ওয়ালেট	ওয়ালেট
জ্যোতিষ্কের	জ্যোতিষ্ক
বীরেন্দ্রনাথ	বীরেন্দ্রনাথ
বামপন্থীরা	বামপন্থী
এমডিজি	এমডিজি
আক্রমণটি	আক্রমণ
তলা	তলা
লিগ	লিগ
দেশপ্রেমী	প্রেম
সেক	সেক
আস্ফালন	আস্ফালন
পাকড়ালো	পাকড়া
বাংলদেশের	বাংলদেশ
জার্মেইন	জার্মেইন
মন্ত্রণালয়	মন্ত্রণালয়
ট্র্যাভেল	ট্র্যাভেল
নিউক্লিয়	নিউক্লিয়
বিলাসবহুল	বিলাস
সৌরজগতের	সৌরজগত
রয়েছিল	রয়
চেন্নাইয়ের	চেন্নাই
অষ্টম	অষ্টম
ইংরেজদের	ইংরেজ
ধর্মাবলম্বীদের	ধর্ম
ভেরিয়েবল	ভেরিয়েবল
কলেস্টেরলের	কলেস্টেরল
এলাকাতেই	এলাকা
বাতাসে	বাতাস
মানসিকতার	মানসিকতা
হাঙ্গেরী	হাঙ্গের
বাসস্টেশন	বাসস্টেশন
স্থানচ্যুতি	স্থান
নিম্নতর	নিম্ন
বনানী	বনানী
ভোঁসলের	ভোঁসল
মনস্থ	মন
শোকার্ত	শোক
ঊনসত্তরের	ঊনসত্তর
শামছুল	শামছুল
মেক্সিকোর	মেক্সিকো
এনক্রিপশন	এনক্রিপশন
ক্রেন	ক্রেন
ঢেকুর	ঢেকুর
রকৃত	রকৃত
মহার্ঘ	মহার্ঘ
শর্করা	শর্করা
বিচূর্ণ	চূর্ণ
ইয়োগা	ইয়োগা
মেষ	মেষ
নেসা	নেসা
দোকানপাটে	দোকান
পশতু	পশতু
গৃহিনী	গৃহিনী
ফকিরপাড়া	ফকির
দম্পতিদের	দম্পতি
হোসনাবাদ	হোসনাবাদ
এটুআই	এটুআই
ম্যাজিস্ট্রেটের	ম্যাজিস্ট্রেট
চেষ্টার	চেষ্টা
আইওটি	আইওটি
বিছানো	বিছান
লাভলু	লাভলু
অক্জিলিয়ারী	অক্জিলিয়ারী
পরিবহনশ্রমিক	শ্রমিক
রটানো	রটানো
দুঃখিত	দুঃখ
সিজার	সিজার
ইপিক্স	ইপিক্স
তুলনীয়	তুলনীয়
জ্বালা	জ্বালা
ক্লাসরুমের	ক্লাসরুম
সহযোদ্ধা	যোদ্ধা
যথাসময়ে	সময়
গৃহে	গৃহ
চক্রান্তকারী	চক্রান্ত
কার্যালয়ও	কার্য
উত্পাদিত	উত্পাদ
অনুগ্রহের	গ্রহ
অস্বস্তিতে	অস্বস্তি
পালসার	পালসার
গাঁথা	গাঁথা
চয়ন	চয়ন
ডাকলাম	ডাকলাম
জিহাদ	জিহাদ
হোটেলগুলোতে	হোটেল
খেললেন	খেলল
তাকাতে	তাকাতে
শাহবাজ	শাহবাজ
আজ্ঞাগুলো	আজ্ঞা
কীগুলির	কী
অসহ্য	সহ্য
ইসরাইল	ইসরাইল
রোগীরা	রোগী
কুঠার	কুঠার
ঝিনাইদহে	ঝিনাইদহ
তোষামোদ	তোষামোদ
মহিলাকে	মহিলা
উন্নীতকরণ	উন্নীত
থখানার	খানার
কোনোরকমে	কোনোরকম
আরবির	আরবি
এএফপিকে	এএফপি
ধোয়া	ধোয়া
রেমিটেন্স	রেমিটেন্স
গাড়িটা	গাড়ি
তামিলদের	তামিল
রিয়েল	রিয়েল
নতজানু	নতজানু
নির্বীজিত	নির্বীজি
পুত্রদের	পুত্র
পেসো	পেস
মিডিয়া	মিডিয়া
আঁকবে	আঁক
টিলা	টিলা
হিউস্টনের	হিউস্টন
আদল	আদল
মুজিবনগরে	মুজিব
গুলিবিদ্ধসহ	গুলি
কনিষ্ঠতম	কনিষ্ঠ
ফাটানো	ফাট
স্টাফদের	স্টাফ
জড়ানো	জড়ান
দিচ্ছ	দিচ্ছ
মজুমদারের	মজুমদার
ফারইস্ট	ফারইস্ট
রিমান্ডের	রিমান্ড
ব্যক্তিমালিকানাধীন	ব্যক্তিমালিকানা
আপোস	আপোস
নেত্রকোণা	নেত্রকোণা
মজাদার	মজা
মিশনসমূহের	মিশন
মেষতুল্য	মেষ
হ্যাজ	হ্যাজ
অপারেটরে	অপারেটর
হাকিমকে	হাকিম
কনার	কনা
সেবারও	সেবা
পড়াকালীন	পড়া
হ্যান্ডসাম	হ্যান্ডসাম
আর্টসে	আর্টস
জাবর	জাবর
লেবেলিং	লেবেল
গোলকধাঁধা	গোলকধাঁধা
বিশ্বাসযোগ্য	বিশ্বাস
প্রচেষ্টাও	প্রচেষ্টা
ওয়াদা	ওয়াদা
কতকাল	কাল
আমতা	আমতা
প্রশ্নও	প্রশ্ন
এক্সন	এক্সন
সুনামের	নাম
ছন্দ	ছন্দ
নটি	নটি
মিনারা	মিনার
বাজাবেন	বাজ
কোম্পানি	কোম্পানি
ডিজাস্টার	ডিজাস্টার
টিটিপি	টিটিপি
ফাঁসিয়াখালী	ফাঁসিয়াখাল
উজ্জ্বলভাবে	উজ্জ্বল
ঝড়বৃষ্টি	ঝড়
রয়েছেঃ	রয়েছে
ইলিয়াসকে	ইলিয়াস
ভূলে	ভূল
অনুত্তীর্ণ	অনুত্তীর্ণ
মডুলার	মডুলার
সাবেক	সাবেক
মধ্যদিয়ে	মধ্য
বিষয়াদি	বিষয়
পাকিস্তানিদের	পাকিস্তানি
আর্মড	আর্মড
জেগেছে	জেগেছে
বার্তাকে	বার্তা
হাঙ্গেরীয়ান	হাঙ্গেরী
দ্রাক্ষারসের	ক্ষার
ইনকয়েরি	ইনকয়েরি
ভেবেই	ভেবে
সংগীতে	সংগীত
আলটিমেটাম	আলটিমেটাম
চোখেও	চোখ
কয়লাখনির	কয়লা
সাজিদুল	সাজিদ
উইলো	উইলো
পাঁচজনই	পাঁচ
পরেরদিন	দিন
শিপইয়ার্ডের	শিপইয়ার্ড
কিনছে	কিনছ
পরিবারতন্ত্র	পরিবার
সেচন	সেচন
তরণী	তরণী
নবীনগর	নবীনগর
নিত্যকার	নিত্য
বয়েল	বয়েল
ইক্ষু	ইক্ষু
দুর্গতদের	দুর্গত
ভেটো	ভেটো
রাখেন	রাখ
চ্যান্সেলর	চ্যান্সেলর
রদায়কে	দায়
তাসমানিয়া	তাসমানিয়া
ঘুরান	ঘুর
অপহূত	অপহূত
প্রতিক	প্রতিক
মোটরসাইকেলটি	মোটরসাইকেল
জায়গাটার	জায়গা
অম্লতা	অম্ল
সহকারীসহ	সহকারী
আগামীকালই	আগামীকাল
জৈনরা	জৈন
বেইজ	বেই
ঘ্রাণ	ঘ্রাণ
নগরবাসী	নগর
বরেণ্য	বরেণ্য
পরিকল্পনার	পরিকল্পনা
অধ্যায়ন	অধ্যায়ন
পারোনা	পারোনা
বয়সেও	বয়স
বর্ষপঞ্জিতে	বর্ষ
সংশোধনের	শোধন
দুরকম	দু
মিটে	মিট
ভট্ট	ভট্ট
তর্ক	তর্ক
সভায়ও	সভা
আপনারা	আপন
মিনুর	মিনু
বাঙালীর	বাঙালী
একাজ	কাজ
প্রথমার	প্রথম
ডীন	ডীন
বেলগাছিয়া	বেল
গল্পকে	গল্প
নাম্বারে	নাম্বার
কাফেরকে	কাফের
হালনাগাদের	হালনাগাদ
অন্তর্ভুক্তিতে	অন্তর্ভুক্ত
মমি	মমি
ভক্সওয়াগেন	ভক্সওয়াগেন
শতাব্দীতে	শতাব্দী
সবকটি	সব
পরবর্তী	বর্তী
নিউম্যাটিক	নিউ
গাড়িতেই	গাড়ি
সেগুলোকে	সেগুলো
অনুঘটকের	অনুঘটক
গড়গড়	গড়গড়
খ্রিস্টানকে	খ্রিস্টান
রাস্তা	রাস্তা
পড়শি	পড়শি
শ্রীলঙ্কার	শ্রীলঙ্কা
সরকারব্যবস্থার	সরকার
থামিয়ে	থামিয়ে
শ্রেডার	শ্রেড
রহস্যময়ী	রহস্য
যোদ্ধাদের	যোদ্ধা
রাধাকান্ত	রাধাকান্ত
লক্ষ্যণীয়	লক্ষ্যণীয়
গুদামে	গুদাম
আরবাজ	আরবাজ
দলটা	দল
মারতেন	মারত
অনুষ্ঠানস্থলে	অনুষ্ঠানস্থল
আমদানীকৃত	আমদানী
চেয়ার	চেয়ার
প্রাণঘাতী	প্রাণ
কাম্বোডিয়া	কাম্বোডিয়া
পার্টটাইম	টাইম
তাবলিগ	তাবলিগ
ভিটামিন	ভিটামিন
নেটওয়ার্কে	নেটওয়ার্ক
রক্তক্ষরণের	রক্ত
আহম্মেদ	আহম্মেদ
কোয়ালিশন	কোয়ালিশন
বেড়েছে	বেড়ে
নাম্বারটা	নাম্বার
এশিয়ান	এশিয়া
পৌঁছার	পৌঁছা
রবীন্দ্রসঙ্গীতের	রবীন্দ্র
মুছে	মুছ
যুবতী	যুবতী
জিমি	জিমি
প্রযোজন	যোজন
অষ্টমবারের	অষ্টমবার
সংগঠনকে	সংগঠন
চতুর্ভুজ	চতুর্ভুজ
ধারার	ধারা
মিসৌরি	মিসৌরি
বাসেই	বাস
ফোর্সেস	ফোর্স
রাজাকারের	রাজা
প্রবর্তন	প্রবর্তন
ট্রিলিয়ন	ট্রিলিয়ন
প্রেমিকা	প্রেমিকা
দূরীকরণে	দূর
ঘোষণাকারীদের	ঘোষণা
পথিক	পথিক
হার্ভার্ড	হার্ভার্ড
এমনসব	এমন
আসমানসমূহে	আসমান
মুম্বাইয়ে	মুম্বাই
ছনুয়া	ছনুয়া
পুষ্পশোভিত	পুষ্প
স্ট্যাম্পড	স্ট্যাম্প
মুক্তভাবে	মুক্ত
নাতালিয়া	নাতালিয়া
সেনগুপ্তের	সেনগুপ্ত
মোরশেদ	মোরশেদ
শয়নকক্ষ	শয়নকক্ষ
বাগদাদ	বাগদাদ
পাঠে	পাঠ
সন্দ্বীপের	সন্দ্বীপ
উপাধিটি	উপাধি
করলো	কর
বলদের	বলদ
প্রয়োজনীয়	জন
উইকিজুনিয়র	উইকিজুনিয়র
রেহমানের	রেহমান
উভয়েই	উভয়
ন্যায়পরায়ণ	ন্যায়পরায়ণ
গতিশীলতা	গতি
ক্লাসিক	ক্লাসিক
মোজাম্বিকের	মোজাম্বিকের
প্রতিভার	প্রতিভা
বালুচরে	বালুচর
ব্যবস্থাপক	ব্যবস্থা
কামারখন্দ	কামারখন্দ
দেশলাই	দেশলাই
অ্যাসপিরিন	অ্যাসপিরিন
বলকে	বল
ইতিকথা	ইতিকথা
লাইফে	লাইফ
মাছি	মাছি
যান্ত্রিকভাবে	যান্ত্রিক
শীতক	শীত
জেগে	জেগে
মেনু	মেনু
খালেকের	খালেক
লুথারের	লুথার
অভিজ্ঞতাই	অভিজ্ঞ
ব্যবস্থাপকেরা	ব্যবস্থাপক
পুঠিয়ার	পুঠিয়া
তামিমি	তামিম
বাটলার	বাটলার
অধ্যায়গুলো	অধ্যায়
জোগানের	জোগান
সেইসময়ে	সময়
নিন্দিত	নিন্দিত
যথোচিত	যথোচিত
খারাপই	খারাপ
গোলাগুলি	গুলি
বিমূঢ়	বিমূঢ়
জোছনার	জোছনা
সঞ্চয়পত্রে	সঞ্চয়
লাউড	লাউড
রুজভেল্টের	রুজভেল্ট
বন্দোবস্ত	বন্দোবস্ত
চক্রীয়	চক্র
কুচকাওয়াজের	ওয়াজ
চিকিত্সাধীন	চিকিত্সা
হাওয়া	হাওয়া
পেপ্যালের	পেপ্যাল
সূচিতে	সূচি
কোল	কোল
প্রত্যেকদিন	প্রত্যেক
পয়সের	পয়স
শরণখোলা	শরণখোলা
জেএসএসের	জেএসএসে
লাশগুলো	লাশ
অস্বস্তি	স্বস্তি
সংগঠনগুলোকে	সংগঠন
প্রক্রিয়াটা	প্রক্রিয়া
মনেহয়	মন
মানিকগঞ্জ	মানিকগঞ্জ
চূড়ায়	চূড়া
পুনর্মুদ্রণ	র্মুদ্র
পেলেও	পেল
তৃতীয়াংশ	তৃতীয়
সরঞ্জাম	সরঞ্জাম
অভিসার	অভিসার
পারদের	পারদ
লিনিয়ার	লিনিয়ার
সঞ্চয়ের	সঞ্চয়
শেফালী	শেফালী
বিস্তারে	বিস্তার
গানগুলোকে	গান
চাড়া	চাড়া
বঙ্গানুবাদ	বঙ্গানুবাদ
হাওরপারের	হাওর
সৎকর্মশীলদের	সৎকর্ম
বালিকা	বালিকা
রেজানুর	রেজানু
লোকমানের	লোকমানের
বাচ্চারাও	বাচ্চা
সমকালের	সমকাল
টেস্টিং	টেস্ট
বিজেপির	বিজেপি
ঐযে	ঐ
মিশছে	মিশ
ফাইন্ডিং	ফাইন্ড
পরপর	পর
জুড়ায়	জুড়া
নেভাল	নেভাল
বিনয়ের	বিনয়
এনালাইসিস	এনালাইসিস
উপেন্দ্রনাথ	উপেন্দ্রনাথ
নবনীতা	নবনীতা
চ্যাপেলের	চ্যাপেল
সাজগোজের	সাজগোজ
জাফলংয়ের	জাফলং
চারার	চারা
এক্সএক্সএল	এক্সএক্সএল
তালাকপ্রাপ্ত	তালাক
খ্রিস্টানের	খ্রিস্টান
চড়াও	চড়া
বলিদান	বলিদান
গলদ	গলদ
চরিত্রেই	চরিত্র
লোকসান	লোকসান
দারুণ	দারুণ
চাতুরীর	চাতুর
পয়োনিষ্কাশন	পয়োনিষ্কাশন
ইয়োব	ইয়োব
কাট	কাট
স্মারকলিপি	স্মারক
জেসিয়া	জেসিয়া
মহিবুল	মহিবুল
আত্মীয়রা	আত্ম
মহাকাব্যিক	কাব্য
মহাকাশযান	মহাকাশযান
বিবরণে	বিবরণ
ওভারে	ওভার
ব্লগও	ব্লগ
পাঞ্জা	পাঞ্জা
আবেগগত	আবেগ
মূর্তিও	মূর্তি
ইলমে	ইলম
অগ্নিনির্বাপক	অগ্নি
হলিউড	হলিউড
ছবিগুলোতে	ছবি
স্বীকারোক্তিমূলক	স্বীকার
হলুদাভ	হলুদ
আগ্রহীদের	আগ্রহ
চাঁদার	চাঁদা
ষোলশহর	ষোলশহর
কোর্সও	কোর্স
ইস্রায়েলের	ইস্রায়েল
সৌরজগতে	সৌরজগত
পথভ	পথ
পুতুলনাচ	পুতুলনাচ
ঘেরের	ঘেরে
কার্লো	কার্লো
দূরান্ত	দূর
প্রকাশ্যে	প্রকাশ্য
নাড়িভুঁড়ি	নাড়ি
সাপ্তাহিককে	সাপ্তাহিক
বুৎপত্তি	বুৎপত্তি
ফিউম	ফিউম
এনএসআই	এনএসআই
পুরুষের	পুরুষ
কোপেন	কোপেন
মওকুফের	মওকুফ
পর্বতময়	পর্বত
লাইভস	লাইভ
রাফাল	রাফাল
আলুমিনা	আলুমিনা
ভাষাগুলোতে	ভাষা
ব্রাসেলসের	ব্রাসেলস
হারটি	হার
সূচনালগ্ন	সূচনা
প্রামাণিকের	প্রামাণিক
ভিয়েনার	ভিয়েনা
এগুলোকে	এগুলো
সেতারা	সেতারা
নেওয়ার	নেওয়া
লাইটনিং	লাইট
শালারা	শালা
আমলেও	আমল
এথেন্সে	এথেন্স
উল্লেখ	উল্লেখ
গোলযোগের	গোলযোগ
খেয়েছিল	খেয়ে
বাইপাস	বাইপাস
রসাতলে	রসাতল
নিরাপত্তাকর্মীকে	নিরাপত্তাকর্মী
রাষ্ট্রীয়	রাষ্ট্র
স্থায়িত্ব	স্থায়ি
শামিমা	শামিমা
বিদিত	বিদিত
টবি	টবি
নানার	নানা
লোকবল	লোক
দায়ূদকে	দায়ূদ
ভয়েসেসের	ভয়েস
সংঘর্ষে	সংঘর্ষ
রমনী	রমনী
পূর্ববঙ্গ	পূর্ববঙ্গ
মেথেনলোন	মেথেনলোন
এয়ারের	এয়ার
পাটনা	পাট
ক্রীড়াঙ্গনে	ক্রীড়াঙ্গনে
আহবায়ক	আহবায়ক
সময়ই	সময়
উপদেষ্টার	উপদেষ্টা
ডিনস	ডিন
রঙগুলি	রঙ
হাসান	হাসান
অফিসে	অফিস
জামিন	জামিন
ফলনের	ফলন
স্বাদু	স্বাদু
সীতাকুণ্ডের	সীতাকুণ্ড
জটের	জট
ড্রেসিং	ড্রেসিং
লিখনের	লিখন
খেতাব	খেতাব
ভিআর	ভিআর
অর্থেও	অর্থ
দুধে	দুধ
উন্নয়নকে	উন্নয়ন
নীলসাগর	সাগর
বেজার	বেজার
উতরাই	উতরা
কয়েকের	কয়েক
ফড়িং	ফড়িং
বাড়াবে	বাড়া
স্কিলস	স্কিল
অবৈধভাবে	অবৈধ
সেক্সের	সেক্স
ভাবিত	ভাবি
খাদ্যগুদাম	খাদ্যগুদাম
সুযোগ	সুযোগ
